farmid,planted_qty,withered_crops,harvested_qty,crop_yield,net_yield,type,tags
1,7,10,16,2.3,6,1,"needs improvement,  bad net yield,  greenhousegrowing,  naturalpestmanagement"
2,20,15,26,1.3,11,1,"terrible crop yield,  good net yield,  companionplanting,  regenerativeagriculture"
3,29,16,28,1,12,0,"average crop yield,  bad net yield,  regenerativeagriculture,  companionplanting"
4,15,4,2,0.1,-2,0,"needs crop improvement,  bad net yield,  irrigation,  fertilization,  soilmanagement"
5,11,11,28,2.5,17,0,"commendable crop yield,  excellent net yield,  pestcontrol,  naturalpestmanagement"
6,8,10,5,0.6,-5,0,"needs crop improvement,  bad net yield,  croprotation,  naturalpestmanagement,  greenhousegrowing"
7,29,14,12,0.4,-2,0,"needs crop improvement,  bad net yield,  regenerativeagriculture,  companionplanting"
8,21,2,27,1.3,25,0,"commendable crop yield,  excellent net yield,  fertilization,  organicfarming"
9,7,0,21,3,21,0,"commendable crop yield,  excellent net yield,  farmersmarket,  localfood,  farmtofork"
10,26,19,8,0.3,-11,0,"needs crop improvement,  bad net yield,  greenhousegrowing,  sustainableagriculture"
11,19,15,6,0.3,-9,0,"needs crop improvement,  bad net yield,  companionplanting,  regenerativeagriculture"
12,23,1,15,0.7,14,1,"terrible crop yield,  good net yield,  pollinatorfriendly,  vermiculture"
13,11,1,25,2.3,24,1,"needs improvement,  excellent net yield,  pollinatorfriendly,  vermiculture"
14,11,2,19,1.7,17,1,"terrible crop yield,  excellent net yield,  organicfarming,  pollinatorfriendly,  soilmanagement"
15,24,7,5,0.2,-2,1,"terrible crop yield,  bad net yield,  pestcontrol,  sustainableagriculture"
16,21,14,12,0.6,-2,0,"needs crop improvement,  bad net yield,  regenerativeagriculture,  companionplanting"
17,4,6,29,7.3,23,0,"commendable crop yield,  excellent net yield,  precisionfarming,  covercrops,  naturalpestmanagement"
18,8,5,26,3.3,21,1,"needs improvement,  excellent net yield,  companionplanting,  greenhousegrowing"
19,24,8,3,0.1,-5,0,"needs crop improvement,  bad net yield,  pestcontrol,  naturalpestmanagement"
20,3,19,2,0.7,-17,1,"terrible crop yield,  bad net yield,  greenhousegrowing,  sustainableagriculture"
21,22,0,6,0.3,6,0,"needs crop improvement, bad net yield, naturalpestmanagement, precisionfarming, sustainableagriculture"
22,21,7,15,0.7,8,1,"terrible crop yield,  bad net yield,  naturalpestmanagement,  covercrops"
23,2,2,23,11.5,21,0,"commendable crop yield,  excellent net yield,  vermiculture,  organicfarming"
24,24,3,12,0.5,9,0,"needs crop improvement,  bad net yield,  fertilization,  soilmanagement,  organicfarming"
25,12,14,16,1.3,2,1,"terrible crop yield,  bad net yield,  regenerativeagriculture,  companionplanting"
26,6,5,6,1,1,0,"average crop yield,  bad net yield,  naturalpestmanagement,  sustainableagriculture"
27,2,14,26,13,12,1,"good crop yield,  good net yield,  companionplanting,  regenerativeagriculture"
28,28,2,25,0.9,23,1,"terrible crop yield,  excellent net yield,  vermiculture,  organicfarming"
29,21,13,5,0.2,-8,1,"terrible crop yield,  bad net yield,  pestcontrol,  croprotation,  naturalpestmanagement"
30,1,19,13,13,-6,1,"good crop yield,  bad net yield,  greenhousegrowing,  sustainableagriculture"
31,12,13,20,1.7,7,0,"commendable crop yield,  bad net yield,  pestcontrol,  croprotation,  naturalpestmanagement"
32,26,3,8,0.3,5,0,"needs crop improvement,  bad net yield,  fertilization,  pollinatorfriendly"
33,22,11,22,1,11,0,"average crop yield,  bad net yield,  naturalpestmanagement,  pestcontrol"
34,29,16,30,1,14,1,"terrible crop yield,  good net yield,  companionplanting,  regenerativeagriculture"
35,12,6,26,2.2,20,0,"commendable crop yield,  excellent net yield,  sustainableagriculture,  companionplanting"
36,25,8,12,0.5,4,1,"terrible crop yield,  bad net yield,  naturalpestmanagement,  pestcontrol"
37,17,2,5,0.3,3,0,"needs crop improvement,  bad net yield,  organicfarming,  irrigation"
38,27,12,13,0.5,1,0,"needs crop improvement,  bad net yield,  pestcontrol,  croprotation,  naturalpestmanagement"
39,27,14,29,1.1,15,0,"commendable crop yield,  bad net yield,  regenerativeagriculture,  companionplanting"
40,10,17,25,2.5,8,1,"needs improvement,  bad net yield,  companionplanting,  regenerativeagriculture"
41,28,18,25,0.9,7,0,"needs crop improvement,  bad net yield,  greenhousegrowing,  sustainableagriculture"
42,28,0,23,0.8,23,0,"needs crop improvement, bad net yield, composting, mulching"
43,16,5,12,0.8,7,1,"terrible crop yield,  bad net yield,  naturalpestmanagement,  companionplanting"
44,15,1,10,0.7,9,0,"needs crop improvement,  bad net yield,  fertilization,  soilmanagement"
45,15,13,3,0.2,-10,1,"terrible crop yield,  bad net yield,  pestcontrol,  croprotation"
46,19,5,23,1.2,18,0,"commendable crop yield,  bad net yield,  croprotation,  naturalpestmanagement"
47,12,13,8,0.7,-5,1,"terrible crop yield,  bad net yield,  croprotation,  pestcontrol,  naturalpestmanagement"
48,23,3,21,0.9,18,1,"terrible crop yield,  excellent net yield,  irrigation,  pollinatorfriendly"
49,20,7,17,0.9,10,0,"needs crop improvement,  bad net yield,  naturalpestmanagement,  companionplanting"
50,25,2,28,1.1,26,1,"terrible crop yield,  excellent net yield,  organicfarming,  fertilization,  soilmanagement"
51,3,18,9,3,-9,1,"needs improvement,  bad net yield,  sustainableagriculture,  greenhousegrowing"
52,5,13,21,4.2,8,1,"needs improvement,  bad net yield,  pestcontrol,  croprotation,  naturalpestmanagement"
53,19,19,30,1.6,11,1,"terrible crop yield,  good net yield,  sustainableagriculture,  greenhousegrowing"
54,7,16,23,3.3,7,1,"needs improvement,  bad net yield,  companionplanting,  regenerativeagriculture"
55,21,7,22,1,15,1,"terrible crop yield,  good net yield,  croprotation,  companionplanting"
56,9,13,13,1.4,0,0,"commendable crop yield,  bad net yield,  naturalpestmanagement,  croprotation,  pestcontrol"
57,7,5,14,2,9,1,"needs improvement,  good net yield,  precisionfarming,  croprotation"
58,18,15,15,0.8,0,1,"terrible crop yield,  bad net yield,  regenerativeagriculture,  companionplanting"
59,4,18,19,4.8,1,0,"commendable crop yield,  bad net yield,  greenhousegrowing,  sustainableagriculture"
60,25,13,8,0.3,-5,0,"needs crop improvement,  bad net yield,  croprotation,  naturalpestmanagement"
61,28,18,22,0.8,4,0,"needs crop improvement,  bad net yield,  sustainableagriculture,  greenhousegrowing"
62,14,2,5,0.4,3,0,"needs crop improvement,  bad net yield,  organicfarming,  pollinatorfriendly"
63,18,9,20,1.1,11,0,"commendable crop yield,  bad net yield,  greenhousegrowing,  croprotation,  companionplanting"
64,26,18,8,0.3,-10,0,"needs crop improvement,  bad net yield,  greenhousegrowing,  sustainableagriculture"
65,9,8,24,2.7,16,0,"commendable crop yield,  excellent net yield,  covercrops,  precisionfarming,  sustainableagriculture"
66,26,19,27,1,8,1,"terrible crop yield,  bad net yield,  greenhousegrowing,  sustainableagriculture"
67,21,12,4,0.2,-8,1,"terrible crop yield,  bad net yield,  pestcontrol,  naturalpestmanagement,  croprotation"
68,2,6,25,12.5,19,0,"commendable crop yield,  excellent net yield,  greenhousegrowing,  croprotation,  covercrops"
69,20,13,7,0.4,-6,1,"terrible crop yield,  bad net yield,  naturalpestmanagement,  croprotation,  pestcontrol"
70,28,8,6,0.2,-2,1,"terrible crop yield,  bad net yield,  sustainableagriculture,  naturalpestmanagement,  pestcontrol"
71,15,18,6,0.4,-12,1,"terrible crop yield,  bad net yield,  sustainableagriculture,  greenhousegrowing"
72,28,14,22,0.8,8,0,"needs crop improvement,  bad net yield,  companionplanting,  regenerativeagriculture"
73,7,19,18,2.6,-1,0,"commendable crop yield,  bad net yield,  greenhousegrowing,  sustainableagriculture"
74,12,13,24,2,11,1,"needs improvement,  good net yield,  pestcontrol,  croprotation"
75,29,5,7,0.2,2,0,"needs crop improvement,  bad net yield,  companionplanting,  sustainableagriculture,  pestcontrol"
76,8,3,10,1.3,7,1,"terrible crop yield,  bad net yield,  organicfarming,  soilmanagement"
77,15,7,4,0.3,-3,1,"terrible crop yield,  bad net yield,  pestcontrol,  naturalpestmanagement,  croprotation"
78,3,16,21,7,5,1,"average crop yield,  bad net yield,  regenerativeagriculture,  companionplanting"
79,14,8,27,1.9,19,1,"terrible crop yield,  excellent net yield,  precisionfarming,  pestcontrol"
80,17,0,6,0.4,6,0,"needs crop improvement, bad net yield, croprotation, covercrops"
81,4,19,20,5,1,0,"commendable crop yield,  bad net yield,  sustainableagriculture,  greenhousegrowing"
82,18,13,2,0.1,-11,0,"needs crop improvement,  bad net yield,  pestcontrol,  naturalpestmanagement"
83,8,10,11,1.4,1,1,"terrible crop yield,  bad net yield,  companionplanting,  sustainableagriculture"
84,4,2,14,3.5,12,0,"commendable crop yield,  excellent net yield,  soilmanagement,  vermiculture"
85,2,8,19,9.5,11,1,"good crop yield,  good net yield,  sustainableagriculture,  pestcontrol"
86,6,13,1,0.2,-12,0,"needs crop improvement,  bad net yield,  naturalpestmanagement,  croprotation,  pestcontrol"
87,22,8,18,0.8,10,1,"terrible crop yield,  good net yield,  covercrops,  naturalpestmanagement,  croprotation"
88,10,3,25,2.5,22,1,"needs improvement,  excellent net yield,  vermiculture,  fertilization,  soilmanagement"
89,4,3,4,1,1,1,"terrible crop yield,  bad net yield,  organicfarming,  pollinatorfriendly"
90,22,7,2,0.1,-5,0,"needs crop improvement,  bad net yield,  naturalpestmanagement,  sustainableagriculture"
91,29,1,9,0.3,8,0,"needs crop improvement,  bad net yield,  pollinatorfriendly,  soilmanagement"
92,18,8,21,1.2,13,0,"commendable crop yield,  bad net yield,  croprotation,  pestcontrol"
93,26,13,2,0.1,-11,0,"needs crop improvement,  bad net yield,  croprotation,  pestcontrol,  naturalpestmanagement"
94,12,8,30,2.5,22,1,"needs improvement,  excellent net yield,  naturalpestmanagement,  companionplanting"
95,2,15,25,12.5,10,0,"commendable crop yield,  excellent net yield,  regenerativeagriculture,  companionplanting"
96,10,16,9,0.9,-7,0,"needs crop improvement,  bad net yield,  regenerativeagriculture,  companionplanting"
97,4,15,10,2.5,-5,1,"needs improvement,  bad net yield,  regenerativeagriculture,  companionplanting"
98,14,11,5,0.4,-6,1,"terrible crop yield,  bad net yield,  naturalpestmanagement,  pestcontrol"
99,16,2,15,0.9,13,1,"terrible crop yield,  good net yield,  organicfarming,  irrigation,  vermiculture"
100,15,10,20,1.3,10,0,"commendable crop yield,  bad net yield,  greenhousegrowing,  croprotation"
101,8,13,3,0.4,-10,1,"terrible crop yield,  bad net yield,  naturalpestmanagement,  pestcontrol,  croprotation"
102,14,17,12,0.9,-5,1,"terrible crop yield,  bad net yield,  companionplanting,  regenerativeagriculture"
103,23,4,10,0.4,6,1,"terrible crop yield,  bad net yield,  organicfarming,  soilmanagement"
104,28,15,18,0.6,3,0,"needs crop improvement,  bad net yield,  regenerativeagriculture,  companionplanting"
105,25,19,4,0.2,-15,1,"terrible crop yield,  bad net yield,  greenhousegrowing,  sustainableagriculture"
106,8,4,6,0.8,2,0,"needs crop improvement,  bad net yield,  pollinatorfriendly,  soilmanagement"
107,21,2,3,0.1,1,0,"needs crop improvement,  bad net yield,  soilmanagement,  vermiculture,  fertilization"
108,16,11,30,1.9,19,1,"terrible crop yield,  excellent net yield,  pestcontrol,  croprotation"
109,13,0,10,0.8,10,1,"terrible crop yield, good net yield, greenhousegrowing, sustainableagriculture"
110,18,8,15,0.8,7,0,"needs crop improvement,  bad net yield,  greenhousegrowing,  precisionfarming,  pestcontrol"
111,15,8,26,1.7,18,1,"terrible crop yield,  excellent net yield,  pestcontrol,  covercrops"
112,21,3,3,0.1,0,1,"terrible crop yield,  bad net yield,  organicfarming,  irrigation"
113,24,2,5,0.2,3,0,"needs crop improvement,  bad net yield,  soilmanagement,  vermiculture,  irrigation"
114,26,16,20,0.8,4,0,"needs crop improvement,  bad net yield,  companionplanting,  regenerativeagriculture"
115,25,1,10,0.4,9,1,"terrible crop yield,  good net yield,  pollinatorfriendly,  vermiculture,  fertilization"
116,28,0,12,0.4,12,0,"needs crop improvement, bad net yield, composting, sustainablepractices, raisedbeds"
117,28,7,9,0.3,2,1,"terrible crop yield,  bad net yield,  greenhousegrowing,  covercrops"
118,28,12,26,0.9,14,1,"terrible crop yield,  good net yield,  pestcontrol,  croprotation,  naturalpestmanagement"
119,13,14,6,0.5,-8,1,"terrible crop yield,  bad net yield,  companionplanting,  regenerativeagriculture"
120,9,7,6,0.7,-1,0,"needs crop improvement,  bad net yield,  precisionfarming,  pestcontrol"
121,29,11,28,1,17,1,"terrible crop yield,  excellent net yield,  pestcontrol,  croprotation"
122,15,11,3,0.2,-8,1,"terrible crop yield,  bad net yield,  naturalpestmanagement,  pestcontrol,  croprotation"
123,13,13,25,1.9,12,1,"terrible crop yield,  good net yield,  croprotation,  pestcontrol"
124,1,14,24,24,10,0,"commendable crop yield,  excellent net yield,  companionplanting,  regenerativeagriculture"
125,25,14,10,0.4,-4,0,"needs crop improvement,  bad net yield,  companionplanting,  regenerativeagriculture"
126,7,8,14,2,6,0,"commendable crop yield,  bad net yield,  companionplanting,  croprotation"
127,9,18,6,0.7,-12,0,"needs crop improvement,  bad net yield,  sustainableagriculture,  greenhousegrowing"
128,24,19,3,0.1,-16,0,"needs crop improvement,  bad net yield,  greenhousegrowing,  sustainableagriculture"
129,1,7,6,6,-1,1,"average crop yield,  bad net yield,  precisionfarming,  greenhousegrowing,  naturalpestmanagement"
130,12,18,7,0.6,-11,0,"needs crop improvement,  bad net yield,  greenhousegrowing,  sustainableagriculture"
131,8,5,20,2.5,15,0,"commendable crop yield,  excellent net yield,  pestcontrol,  sustainableagriculture"
132,24,19,14,0.6,-5,0,"needs crop improvement,  bad net yield,  sustainableagriculture,  greenhousegrowing"
133,11,18,7,0.6,-11,1,"terrible crop yield,  bad net yield,  sustainableagriculture,  greenhousegrowing"
134,19,3,15,0.8,12,0,"needs crop improvement,  bad net yield,  organicfarming,  pollinatorfriendly"
135,17,6,21,1.2,15,0,"commendable crop yield,  bad net yield,  companionplanting,  precisionfarming,  pestcontrol"
136,8,3,17,2.1,14,1,"needs improvement,  good net yield,  vermiculture,  fertilization,  soilmanagement"
137,3,11,2,0.7,-9,0,"needs crop improvement,  bad net yield,  naturalpestmanagement,  croprotation,  pestcontrol"
138,3,12,29,9.7,17,1,"good crop yield,  excellent net yield,  naturalpestmanagement,  croprotation,  pestcontrol"
139,1,2,6,6,4,1,"average crop yield,  bad net yield,  pollinatorfriendly,  vermiculture,  fertilization"
140,27,11,14,0.5,3,1,"terrible crop yield,  bad net yield,  croprotation,  naturalpestmanagement,  pestcontrol"
141,5,1,18,3.6,17,1,"needs improvement,  excellent net yield,  irrigation,  fertilization,  pollinatorfriendly"
142,10,1,19,1.9,18,1,"terrible crop yield,  excellent net yield,  organicfarming,  soilmanagement,  fertilization"
143,7,8,20,2.9,12,0,"commendable crop yield,  excellent net yield,  precisionfarming,  sustainableagriculture,  croprotation"
144,26,0,14,0.5,14,1,"terrible crop yield, good net yield, sustainableagriculture, precisionfarming, greenhousegrowing"
145,9,7,30,3.3,23,1,"needs improvement,  excellent net yield,  companionplanting,  naturalpestmanagement"
146,28,5,25,0.9,20,0,"needs crop improvement,  bad net yield,  greenhousegrowing,  covercrops,  companionplanting"
147,7,5,27,3.9,22,1,"needs improvement,  excellent net yield,  companionplanting,  covercrops,  pestcontrol"
148,9,17,25,2.8,8,0,"commendable crop yield,  bad net yield,  companionplanting,  regenerativeagriculture"
149,8,16,29,3.6,13,0,"commendable crop yield,  excellent net yield,  companionplanting,  regenerativeagriculture"
150,12,11,22,1.8,11,0,"commendable crop yield,  bad net yield,  pestcontrol,  naturalpestmanagement,  croprotation"
151,2,5,3,1.5,-2,1,"terrible crop yield,  bad net yield,  covercrops,  croprotation"
152,1,7,9,9,2,1,"good crop yield,  bad net yield,  pestcontrol,  covercrops,  croprotation"
153,16,18,28,1.8,10,1,"terrible crop yield,  good net yield,  greenhousegrowing,  sustainableagriculture"
154,23,9,1,0,-8,0,"needs crop improvement,  bad net yield,  greenhousegrowing,  naturalpestmanagement"
155,23,0,14,0.6,14,1,"terrible crop yield, good net yield, permaculture, covercrops, sustainableagriculture"
156,24,12,2,0.1,-10,1,"terrible crop yield,  bad net yield,  croprotation,  naturalpestmanagement,  pestcontrol"
157,5,16,7,1.4,-9,1,"terrible crop yield,  bad net yield,  regenerativeagriculture,  companionplanting"
158,3,2,14,4.7,12,0,"commendable crop yield,  excellent net yield,  fertilization,  vermiculture"
159,12,7,29,2.4,22,0,"commendable crop yield,  excellent net yield,  precisionfarming,  pestcontrol,  naturalpestmanagement"
160,8,13,17,2.1,4,1,"needs improvement,  bad net yield,  naturalpestmanagement,  pestcontrol"
161,22,2,9,0.4,7,1,"terrible crop yield,  bad net yield,  irrigation,  vermiculture"
162,27,15,29,1.1,14,1,"terrible crop yield,  good net yield,  companionplanting,  regenerativeagriculture"
163,3,12,2,0.7,-10,1,"terrible crop yield,  bad net yield,  naturalpestmanagement,  pestcontrol"
164,1,19,6,6,-13,0,"commendable crop yield,  bad net yield,  greenhousegrowing,  sustainableagriculture"
165,3,16,25,8.3,9,0,"commendable crop yield,  excellent net yield,  companionplanting,  regenerativeagriculture"
166,5,12,13,2.6,1,0,"commendable crop yield,  bad net yield,  naturalpestmanagement,  croprotation"
167,15,5,21,1.4,16,0,"commendable crop yield,  excellent net yield,  greenhousegrowing,  companionplanting,  sustainableagriculture"
168,14,16,14,1,-2,1,"terrible crop yield,  bad net yield,  regenerativeagriculture,  companionplanting"
169,3,13,12,4,-1,1,"needs improvement,  bad net yield,  naturalpestmanagement,  croprotation"
170,1,16,14,14,-2,1,"good crop yield,  bad net yield,  companionplanting,  regenerativeagriculture"
171,5,7,2,0.4,-5,0,"needs crop improvement,  bad net yield,  covercrops,  naturalpestmanagement,  pestcontrol"
172,26,10,22,0.8,12,1,"terrible crop yield,  good net yield,  sustainableagriculture,  greenhousegrowing"
173,23,19,25,1.1,6,0,"commendable crop yield,  bad net yield,  greenhousegrowing,  sustainableagriculture"
174,14,0,15,1.1,15,0,"commendable crop yield,  excellent net yield,  foodsecurity,  farmtofork,  farmersmarket"
175,7,6,28,4,22,1,"needs improvement,  excellent net yield,  covercrops,  sustainableagriculture,  naturalpestmanagement"
176,27,16,7,0.3,-9,1,"terrible crop yield,  bad net yield,  regenerativeagriculture,  companionplanting"
177,9,9,29,3.2,20,1,"needs improvement,  excellent net yield,  precisionfarming,  naturalpestmanagement,  croprotation"
178,15,10,12,0.8,2,0,"needs crop improvement,  bad net yield,  greenhousegrowing,  sustainableagriculture"
179,15,8,6,0.4,-2,1,"terrible crop yield,  bad net yield,  covercrops,  sustainableagriculture"
180,26,8,13,0.5,5,0,"needs crop improvement,  bad net yield,  sustainableagriculture,  naturalpestmanagement"
181,10,4,14,1.4,10,1,"terrible crop yield,  good net yield,  soilmanagement,  vermiculture"
182,28,16,20,0.7,4,0,"needs crop improvement,  bad net yield,  companionplanting,  regenerativeagriculture"
183,13,8,18,1.4,10,0,"commendable crop yield,  bad net yield,  greenhousegrowing,  companionplanting,  croprotation"
184,19,16,20,1.1,4,1,"terrible crop yield,  bad net yield,  regenerativeagriculture,  companionplanting"
185,7,18,28,4,10,0,"commendable crop yield,  excellent net yield,  greenhousegrowing,  sustainableagriculture"
186,17,6,6,0.4,0,0,"needs crop improvement,  bad net yield,  pestcontrol,  companionplanting"
187,20,8,11,0.6,3,1,"terrible crop yield,  bad net yield,  greenhousegrowing,  sustainableagriculture,  pestcontrol"
188,29,6,11,0.4,5,0,"needs crop improvement,  bad net yield,  covercrops,  sustainableagriculture,  naturalpestmanagement"
189,4,12,22,5.5,10,1,"average crop yield,  good net yield,  pestcontrol,  croprotation"
190,5,10,28,5.6,18,0,"commendable crop yield,  excellent net yield,  naturalpestmanagement,  sustainableagriculture,  greenhousegrowing"
191,23,13,19,0.8,6,1,"terrible crop yield,  bad net yield,  croprotation,  naturalpestmanagement"
192,7,18,5,0.7,-13,1,"terrible crop yield,  bad net yield,  greenhousegrowing,  sustainableagriculture"
193,13,10,19,1.5,9,0,"commendable crop yield,  bad net yield,  companionplanting,  pestcontrol,  greenhousegrowing"
194,15,12,5,0.3,-7,0,"needs crop improvement,  bad net yield,  pestcontrol,  naturalpestmanagement,  croprotation"
195,11,13,19,1.7,6,0,"commendable crop yield,  bad net yield,  croprotation,  pestcontrol,  naturalpestmanagement"
196,29,12,2,0.1,-10,0,"needs crop improvement,  bad net yield,  croprotation,  pestcontrol"
197,4,0,10,2.5,10,0,"commendable crop yield,  excellent net yield,  farmtofork,  localfood"
198,13,7,8,0.6,1,1,"terrible crop yield,  bad net yield,  sustainableagriculture,  croprotation"
199,7,11,2,0.3,-9,0,"needs crop improvement,  bad net yield,  croprotation,  naturalpestmanagement,  pestcontrol"
200,27,18,14,0.5,-4,1,"terrible crop yield,  bad net yield,  sustainableagriculture,  greenhousegrowing"
201,19,11,15,0.8,4,1,"terrible crop yield,  bad net yield,  croprotation,  pestcontrol,  naturalpestmanagement"
202,22,7,29,1.3,22,0,"commendable crop yield,  good net yield,  greenhousegrowing,  naturalpestmanagement,  croprotation"
203,28,7,18,0.6,11,1,"terrible crop yield,  good net yield,  covercrops,  naturalpestmanagement,  croprotation"
204,2,12,10,5,-2,1,"average crop yield,  bad net yield,  croprotation,  naturalpestmanagement,  pestcontrol"
205,10,11,18,1.8,7,1,"terrible crop yield,  bad net yield,  naturalpestmanagement,  croprotation,  pestcontrol"
206,13,15,9,0.7,-6,1,"terrible crop yield,  bad net yield,  regenerativeagriculture,  companionplanting"
207,25,0,19,0.8,19,0,"needs crop improvement, bad net yield, sustainablepractices, raisedbeds"
208,21,12,29,1.4,17,1,"terrible crop yield,  excellent net yield,  croprotation,  naturalpestmanagement,  pestcontrol"
209,6,6,3,0.5,-3,0,"needs crop improvement,  bad net yield,  naturalpestmanagement,  covercrops"
210,28,4,21,0.8,17,0,"needs crop improvement,  bad net yield,  organicfarming,  irrigation"
211,28,7,4,0.1,-3,1,"terrible crop yield,  bad net yield,  naturalpestmanagement,  companionplanting"
212,12,13,28,2.3,15,0,"commendable crop yield,  excellent net yield,  croprotation,  pestcontrol"
213,12,12,14,1.2,2,0,"commendable crop yield,  bad net yield,  naturalpestmanagement,  pestcontrol"
214,20,14,19,1,5,0,"average crop yield,  bad net yield,  companionplanting,  regenerativeagriculture"
215,11,16,8,0.7,-8,1,"terrible crop yield,  bad net yield,  regenerativeagriculture,  companionplanting"
216,26,14,16,0.6,2,0,"needs crop improvement,  bad net yield,  companionplanting,  regenerativeagriculture"
217,23,19,16,0.7,-3,0,"needs crop improvement,  bad net yield,  sustainableagriculture,  greenhousegrowing"
218,28,17,28,1,11,0,"average crop yield,  bad net yield,  companionplanting,  regenerativeagriculture"
219,25,17,29,1.2,12,1,"terrible crop yield,  good net yield,  companionplanting,  regenerativeagriculture"
220,7,1,4,0.6,3,0,"needs crop improvement,  bad net yield,  pollinatorfriendly,  vermiculture"
221,1,3,16,16,13,1,"commendable crop yield,  good net yield,  vermiculture,  organicfarming,  soilmanagement"
222,1,0,6,6,6,1,"average crop yield, bad net yield, irrigation, fertilization, greenhousegrowing, croprotation, covercrops"
223,25,3,30,1.2,27,1,"terrible crop yield,  excellent net yield,  organicfarming,  irrigation"
224,27,17,23,0.9,6,1,"terrible crop yield,  bad net yield,  regenerativeagriculture,  companionplanting"
225,25,4,5,0.2,1,1,"terrible crop yield,  bad net yield,  fertilization,  irrigation"
226,20,18,21,1.1,3,1,"terrible crop yield,  bad net yield,  sustainableagriculture,  greenhousegrowing"
227,13,14,28,2.2,14,0,"commendable crop yield,  excellent net yield,  regenerativeagriculture,  companionplanting"
228,9,7,19,2.1,12,1,"needs improvement,  good net yield,  naturalpestmanagement,  covercrops"
229,3,19,29,9.7,10,0,"commendable crop yield,  excellent net yield,  sustainableagriculture,  greenhousegrowing"
230,7,16,20,2.9,4,0,"commendable crop yield,  bad net yield,  companionplanting,  regenerativeagriculture"
231,6,0,18,3,18,1,"needs improvement, excellent net yield, covercrops, pestcontrol, sustainableagriculture"
232,8,11,28,3.5,17,0,"commendable crop yield,  excellent net yield,  naturalpestmanagement,  croprotation"
233,27,18,6,0.2,-12,0,"needs crop improvement,  bad net yield,  greenhousegrowing,  sustainableagriculture"
234,9,14,7,0.8,-7,0,"needs crop improvement,  bad net yield,  companionplanting,  regenerativeagriculture"
235,5,8,18,3.6,10,0,"commendable crop yield,  excellent net yield,  pestcontrol,  sustainableagriculture"
236,1,6,23,23,17,1,"commendable crop yield,  excellent net yield,  covercrops,  croprotation"
237,19,1,20,1.1,19,0,"commendable crop yield,  good net yield,  soilmanagement,  pollinatorfriendly"
238,10,8,23,2.3,15,1,"needs improvement,  good net yield,  sustainableagriculture,  covercrops,  precisionfarming"
239,12,9,3,0.3,-6,0,"needs crop improvement,  bad net yield,  naturalpestmanagement,  greenhousegrowing,  covercrops"
240,24,1,7,0.3,6,0,"needs crop improvement,  bad net yield,  pollinatorfriendly,  organicfarming"
241,15,18,28,1.9,10,1,"terrible crop yield,  good net yield,  sustainableagriculture,  greenhousegrowing"
242,27,10,28,1,18,0,"average crop yield,  bad net yield,  greenhousegrowing,  pestcontrol"
243,22,12,22,1,10,0,"average crop yield,  bad net yield,  naturalpestmanagement,  croprotation,  pestcontrol"
244,24,9,14,0.6,5,0,"needs crop improvement,  bad net yield,  covercrops,  greenhousegrowing"
245,9,13,16,1.8,3,1,"terrible crop yield,  bad net yield,  croprotation,  naturalpestmanagement"
246,20,17,5,0.3,-12,0,"needs crop improvement,  bad net yield,  regenerativeagriculture,  companionplanting"
247,17,18,13,0.8,-5,1,"terrible crop yield,  bad net yield,  sustainableagriculture,  greenhousegrowing"
248,17,8,22,1.3,14,0,"commendable crop yield,  bad net yield,  covercrops,  greenhousegrowing"
249,26,6,28,1.1,22,1,"terrible crop yield,  excellent net yield,  croprotation,  pestcontrol"
250,20,2,4,0.2,2,1,"terrible crop yield,  bad net yield,  soilmanagement,  pollinatorfriendly,  irrigation"
251,12,19,2,0.2,-17,0,"needs crop improvement,  bad net yield,  greenhousegrowing,  sustainableagriculture"
252,7,5,27,3.9,22,0,"commendable crop yield,  excellent net yield,  covercrops,  sustainableagriculture,  pestcontrol"
253,2,1,13,6.5,12,1,"average crop yield,  good net yield,  fertilization,  soilmanagement,  vermiculture"
254,3,5,8,2.7,3,1,"needs improvement,  bad net yield,  pestcontrol,  greenhousegrowing"
255,17,2,6,0.4,4,0,"needs crop improvement,  bad net yield,  fertilization,  soilmanagement"
256,5,15,12,2.4,-3,1,"needs improvement,  bad net yield,  regenerativeagriculture,  companionplanting"
257,17,7,21,1.2,14,0,"commendable crop yield,  bad net yield,  greenhousegrowing,  croprotation,  precisionfarming"
258,24,1,10,0.4,9,0,"needs crop improvement,  bad net yield,  fertilization,  pollinatorfriendly"
259,17,16,23,1.4,7,0,"commendable crop yield,  bad net yield,  companionplanting,  regenerativeagriculture"
260,27,8,26,1,18,0,"average crop yield,  bad net yield,  greenhousegrowing,  naturalpestmanagement,  croprotation"
261,17,11,20,1.2,9,1,"terrible crop yield,  good net yield,  pestcontrol,  naturalpestmanagement"
262,2,2,7,3.5,5,0,"commendable crop yield,  excellent net yield,  soilmanagement,  pollinatorfriendly"
263,2,10,27,13.5,17,1,"good crop yield,  excellent net yield,  naturalpestmanagement,  pestcontrol,  precisionfarming"
264,28,0,1,0,1,0,"needs crop improvement, bad net yield, precisionfarming, sustainableagriculture, covercrops"
265,22,12,27,1.2,15,1,"terrible crop yield,  good net yield,  pestcontrol,  naturalpestmanagement,  croprotation"
266,23,14,21,0.9,7,0,"needs crop improvement,  bad net yield,  companionplanting,  regenerativeagriculture"
267,5,4,15,3,11,1,"needs improvement,  good net yield,  soilmanagement,  irrigation"
268,1,16,3,3,-13,1,"needs improvement,  bad net yield,  regenerativeagriculture,  companionplanting"
269,1,5,13,13,8,0,"commendable crop yield,  excellent net yield,  greenhousegrowing,  naturalpestmanagement,  companionplanting"
270,19,10,21,1.1,11,0,"commendable crop yield,  bad net yield,  sustainableagriculture,  pestcontrol,  croprotation"
271,2,17,21,10.5,4,0,"commendable crop yield,  excellent net yield,  regenerativeagriculture,  companionplanting"
272,21,3,18,0.9,15,0,"needs crop improvement,  bad net yield,  irrigation,  pollinatorfriendly,  soilmanagement"
273,12,2,14,1.2,12,1,"terrible crop yield,  good net yield,  pollinatorfriendly,  organicfarming"
274,26,12,13,0.5,1,0,"needs crop improvement,  bad net yield,  pestcontrol,  naturalpestmanagement,  croprotation"
275,6,8,8,1.3,0,1,"terrible crop yield,  bad net yield,  greenhousegrowing,  precisionfarming,  naturalpestmanagement"
276,23,5,16,0.7,11,1,"terrible crop yield,  good net yield,  pestcontrol,  greenhousegrowing"
277,4,11,3,0.8,-8,0,"needs crop improvement,  bad net yield,  croprotation,  pestcontrol,  naturalpestmanagement"
278,23,1,30,1.3,29,1,"terrible crop yield,  excellent net yield,  organicfarming,  pollinatorfriendly,  irrigation"
279,11,2,30,2.7,28,1,"needs improvement,  excellent net yield,  organicfarming,  soilmanagement,  fertilization"
280,24,2,12,0.5,10,1,"terrible crop yield,  good net yield,  vermiculture,  organicfarming,  soilmanagement"
281,27,11,21,0.8,10,1,"terrible crop yield,  good net yield,  croprotation,  pestcontrol"
282,17,14,20,1.2,6,0,"commendable crop yield,  bad net yield,  companionplanting,  regenerativeagriculture"
283,6,8,23,3.8,15,0,"commendable crop yield,  excellent net yield,  croprotation,  covercrops,  greenhousegrowing"
284,24,7,21,0.9,14,0,"needs crop improvement,  bad net yield,  pestcontrol,  precisionfarming,  greenhousegrowing"
285,5,10,26,5.2,16,0,"commendable crop yield,  excellent net yield,  precisionfarming,  croprotation"
286,20,15,23,1.2,8,1,"terrible crop yield,  bad net yield,  companionplanting,  regenerativeagriculture"
287,2,3,12,6,9,1,"average crop yield,  good net yield,  organicfarming,  pollinatorfriendly"
288,6,0,20,3.3,20,0,"commendable crop yield,  excellent net yield,  foodsecurity,  farmersmarket"
289,22,6,16,0.7,10,0,"needs crop improvement,  bad net yield,  greenhousegrowing,  naturalpestmanagement"
290,11,1,28,2.5,27,0,"commendable crop yield,  excellent net yield,  pollinatorfriendly,  fertilization"
291,16,4,13,0.8,9,1,"terrible crop yield,  good net yield,  fertilization,  vermiculture,  soilmanagement"
292,16,6,8,0.5,2,0,"needs crop improvement,  bad net yield,  naturalpestmanagement,  precisionfarming"
293,1,3,3,3,0,0,"commendable crop yield,  bad net yield,  fertilization,  organicfarming"
294,9,4,9,1,5,0,"average crop yield,  bad net yield,  pollinatorfriendly,  fertilization,  soilmanagement"
295,28,0,22,0.8,22,1,"terrible crop yield, excellent net yield, greenhousegrowing, precisionfarming"
296,27,0,16,0.6,16,1,"terrible crop yield, excellent net yield, permaculture, sustainableagriculture, covercrops"
297,6,14,17,2.8,3,1,"needs improvement,  bad net yield,  companionplanting,  regenerativeagriculture"
298,16,19,6,0.4,-13,1,"terrible crop yield,  bad net yield,  greenhousegrowing,  sustainableagriculture"
299,29,18,28,1,10,1,"terrible crop yield,  good net yield,  sustainableagriculture,  greenhousegrowing"
300,3,9,21,7,12,1,"average crop yield,  good net yield,  naturalpestmanagement,  covercrops,  greenhousegrowing"
301,20,17,7,0.4,-10,1,"terrible crop yield,  bad net yield,  regenerativeagriculture,  companionplanting"
302,28,2,20,0.7,18,1,"terrible crop yield,  excellent net yield,  fertilization,  pollinatorfriendly,  soilmanagement"
303,27,10,17,0.6,7,0,"needs crop improvement,  bad net yield,  pestcontrol,  precisionfarming,  sustainableagriculture"
304,4,14,9,2.3,-5,0,"commendable crop yield,  bad net yield,  companionplanting,  regenerativeagriculture"
305,19,10,4,0.2,-6,1,"terrible crop yield,  bad net yield,  naturalpestmanagement,  sustainableagriculture"
306,26,16,28,1.1,12,1,"terrible crop yield,  good net yield,  regenerativeagriculture,  companionplanting"
307,3,16,9,3,-7,0,"commendable crop yield,  bad net yield,  regenerativeagriculture,  companionplanting"
308,19,5,27,1.4,22,1,"terrible crop yield,  excellent net yield,  precisionfarming,  naturalpestmanagement,  greenhousegrowing"
309,20,4,29,1.5,25,1,"terrible crop yield,  excellent net yield,  irrigation,  pollinatorfriendly,  fertilization"
310,7,7,7,1,0,1,"terrible crop yield,  bad net yield,  pestcontrol,  companionplanting"
311,20,1,28,1.4,27,0,"commendable crop yield,  excellent net yield,  irrigation,  vermiculture"
312,9,15,16,1.8,1,0,"commendable crop yield,  bad net yield,  companionplanting,  regenerativeagriculture"
313,1,19,29,29,10,0,"commendable crop yield,  excellent net yield,  greenhousegrowing,  sustainableagriculture"
314,8,11,1,0.1,-10,0,"needs crop improvement,  bad net yield,  croprotation,  pestcontrol"
315,7,5,10,1.4,5,0,"commendable crop yield,  bad net yield,  pestcontrol,  naturalpestmanagement"
316,18,0,26,1.4,26,1,"terrible crop yield, excellent net yield, greenhousegrowing, permaculture, precisionfarming"
317,8,3,26,3.3,23,0,"commendable crop yield,  excellent net yield,  fertilization,  organicfarming,  vermiculture"
318,1,16,13,13,-3,1,"good crop yield,  bad net yield,  regenerativeagriculture,  companionplanting"
319,11,12,19,1.7,7,1,"terrible crop yield,  bad net yield,  croprotation,  naturalpestmanagement,  pestcontrol"
320,28,17,21,0.8,4,0,"needs crop improvement,  bad net yield,  companionplanting,  regenerativeagriculture"
321,25,4,28,1.1,24,0,"commendable crop yield,  bad net yield,  soilmanagement,  fertilization,  organicfarming"
322,25,2,17,0.7,15,1,"terrible crop yield,  good net yield,  vermiculture,  soilmanagement"
323,18,10,28,1.6,18,1,"terrible crop yield,  excellent net yield,  pestcontrol,  companionplanting,  sustainableagriculture"
324,23,12,9,0.4,-3,1,"terrible crop yield,  bad net yield,  pestcontrol,  croprotation,  naturalpestmanagement"
325,10,3,8,0.8,5,0,"needs crop improvement,  bad net yield,  pollinatorfriendly,  soilmanagement,  organicfarming"
326,3,13,27,9,14,0,"commendable crop yield,  excellent net yield,  pestcontrol,  croprotation,  naturalpestmanagement"
327,7,10,22,3.1,12,0,"commendable crop yield,  excellent net yield,  croprotation,  sustainableagriculture,  companionplanting"
328,28,9,8,0.3,-1,0,"needs crop improvement,  bad net yield,  greenhousegrowing,  naturalpestmanagement,  croprotation"
329,16,18,17,1.1,-1,0,"commendable crop yield,  bad net yield,  greenhousegrowing,  sustainableagriculture"
330,26,17,22,0.8,5,1,"terrible crop yield,  bad net yield,  companionplanting,  regenerativeagriculture"
331,16,5,17,1.1,12,0,"commendable crop yield,  bad net yield,  pestcontrol,  greenhousegrowing"
332,25,14,16,0.6,2,1,"terrible crop yield,  bad net yield,  companionplanting,  regenerativeagriculture"
333,20,9,28,1.4,19,1,"terrible crop yield,  excellent net yield,  croprotation,  covercrops,  sustainableagriculture"
334,28,4,15,0.5,11,1,"terrible crop yield,  good net yield,  vermiculture,  organicfarming"
335,17,4,13,0.8,9,0,"needs crop improvement,  bad net yield,  organicfarming,  fertilization"
336,2,9,19,9.5,10,0,"commendable crop yield,  excellent net yield,  pestcontrol,  sustainableagriculture"
337,1,4,5,5,1,0,"commendable crop yield,  good net yield,  organicfarming,  vermiculture,  soilmanagement"
338,16,2,4,0.3,2,1,"terrible crop yield,  bad net yield,  vermiculture,  organicfarming"
339,12,5,30,2.5,25,1,"needs improvement,  excellent net yield,  sustainableagriculture,  companionplanting"
340,5,3,13,2.6,10,1,"needs improvement,  good net yield,  vermiculture,  soilmanagement"
341,5,17,22,4.4,5,1,"needs improvement,  bad net yield,  regenerativeagriculture,  companionplanting"
342,27,8,25,0.9,17,1,"terrible crop yield,  excellent net yield,  sustainableagriculture,  precisionfarming,  greenhousegrowing"
343,23,16,29,1.3,13,1,"terrible crop yield,  good net yield,  regenerativeagriculture,  companionplanting"
344,9,12,8,0.9,-4,0,"needs crop improvement,  bad net yield,  naturalpestmanagement,  croprotation"
345,9,14,25,2.8,11,0,"commendable crop yield,  excellent net yield,  companionplanting,  regenerativeagriculture"
346,3,19,23,7.7,4,0,"commendable crop yield,  excellent net yield,  greenhousegrowing,  sustainableagriculture"
347,19,16,11,0.6,-5,0,"needs crop improvement,  bad net yield,  companionplanting,  regenerativeagriculture"
348,16,12,16,1,4,1,"terrible crop yield,  bad net yield,  naturalpestmanagement,  pestcontrol"
349,16,15,26,1.6,11,1,"terrible crop yield,  good net yield,  regenerativeagriculture,  companionplanting"
350,3,3,19,6.3,16,0,"commendable crop yield,  excellent net yield,  soilmanagement,  fertilization,  pollinatorfriendly"
351,20,4,8,0.4,4,1,"terrible crop yield,  bad net yield,  organicfarming,  pollinatorfriendly,  fertilization"
352,24,4,3,0.1,-1,0,"needs crop improvement,  bad net yield,  soilmanagement,  irrigation"
353,22,8,24,1.1,16,0,"commendable crop yield,  bad net yield,  croprotation,  sustainableagriculture,  precisionfarming"
354,24,16,17,0.7,1,0,"needs crop improvement,  bad net yield,  companionplanting,  regenerativeagriculture"
355,1,12,5,5,-7,1,"average crop yield,  bad net yield,  pestcontrol,  croprotation"
356,24,1,20,0.8,19,0,"needs crop improvement,  bad net yield,  irrigation,  fertilization,  soilmanagement"
357,20,12,21,1.1,9,0,"commendable crop yield,  bad net yield,  croprotation,  pestcontrol"
358,11,18,8,0.7,-10,0,"needs crop improvement,  bad net yield,  sustainableagriculture,  greenhousegrowing"
359,17,2,26,1.5,24,1,"terrible crop yield,  excellent net yield,  soilmanagement,  fertilization"
360,8,9,29,3.6,20,1,"needs improvement,  excellent net yield,  naturalpestmanagement,  greenhousegrowing,  croprotation"
361,4,1,4,1,3,0,"average crop yield,  bad net yield,  organicfarming,  soilmanagement,  pollinatorfriendly"
362,6,12,23,3.8,11,1,"needs improvement,  good net yield,  croprotation,  pestcontrol,  naturalpestmanagement"
363,8,18,22,2.8,4,1,"needs improvement,  bad net yield,  greenhousegrowing,  sustainableagriculture"
364,20,16,22,1.1,6,1,"terrible crop yield,  bad net yield,  regenerativeagriculture,  companionplanting"
365,3,13,3,1,-10,1,"terrible crop yield,  bad net yield,  croprotation,  naturalpestmanagement"
366,16,11,25,1.6,14,1,"terrible crop yield,  good net yield,  croprotation,  pestcontrol"
367,25,11,9,0.4,-2,1,"terrible crop yield,  bad net yield,  croprotation,  naturalpestmanagement"
368,3,10,12,4,2,1,"needs improvement,  bad net yield,  covercrops,  companionplanting"
369,25,6,14,0.6,8,1,"terrible crop yield,  bad net yield,  covercrops,  pestcontrol"
370,29,3,18,0.6,15,1,"terrible crop yield,  good net yield,  pollinatorfriendly,  soilmanagement"
371,18,18,9,0.5,-9,1,"terrible crop yield,  bad net yield,  greenhousegrowing,  sustainableagriculture"
372,14,0,5,0.4,5,0,"needs crop improvement, bad net yield, pestcontrol, croprotation"
373,18,2,5,0.3,3,0,"needs crop improvement,  bad net yield,  fertilization,  organicfarming,  soilmanagement"
374,2,12,19,9.5,7,1,"good crop yield,  bad net yield,  pestcontrol,  naturalpestmanagement"
375,22,14,8,0.4,-6,0,"needs crop improvement,  bad net yield,  regenerativeagriculture,  companionplanting"
376,3,1,10,3.3,9,0,"commendable crop yield,  excellent net yield,  vermiculture,  soilmanagement,  irrigation"
377,16,10,7,0.4,-3,1,"terrible crop yield,  bad net yield,  greenhousegrowing,  pestcontrol"
378,29,3,12,0.4,9,1,"terrible crop yield,  good net yield,  vermiculture,  irrigation"
379,9,18,14,1.6,-4,1,"terrible crop yield,  bad net yield,  greenhousegrowing,  sustainableagriculture"
380,4,16,28,7,12,0,"commendable crop yield,  excellent net yield,  companionplanting,  regenerativeagriculture"
381,1,2,17,17,15,0,"commendable crop yield,  excellent net yield,  irrigation,  soilmanagement,  pollinatorfriendly"
382,4,17,29,7.3,12,1,"average crop yield,  good net yield,  regenerativeagriculture,  companionplanting"
383,1,7,7,7,0,1,"average crop yield,  bad net yield,  companionplanting,  covercrops"
384,14,18,10,0.7,-8,1,"terrible crop yield,  bad net yield,  sustainableagriculture,  greenhousegrowing"
385,21,4,9,0.4,5,0,"needs crop improvement,  bad net yield,  fertilization,  irrigation"
386,16,6,2,0.1,-4,0,"needs crop improvement,  bad net yield,  greenhousegrowing,  naturalpestmanagement,  croprotation"
387,20,7,15,0.8,8,0,"needs crop improvement,  bad net yield,  croprotation,  companionplanting,  sustainableagriculture"
388,24,4,18,0.8,14,0,"needs crop improvement,  bad net yield,  irrigation,  soilmanagement"
389,8,16,25,3.1,9,1,"needs improvement,  good net yield,  regenerativeagriculture,  companionplanting"
390,7,4,10,1.4,6,1,"terrible crop yield,  bad net yield,  soilmanagement,  pollinatorfriendly"
391,3,3,18,6,15,1,"average crop yield,  good net yield,  vermiculture,  irrigation"
392,17,18,13,0.8,-5,1,"terrible crop yield,  bad net yield,  greenhousegrowing,  sustainableagriculture"
393,1,1,14,14,13,0,"commendable crop yield,  excellent net yield,  organicfarming,  soilmanagement,  pollinatorfriendly"
394,16,10,9,0.6,-1,0,"needs crop improvement,  bad net yield,  naturalpestmanagement,  croprotation,  companionplanting"
395,12,12,16,1.3,4,1,"terrible crop yield,  bad net yield,  croprotation,  naturalpestmanagement,  pestcontrol"
396,27,14,17,0.6,3,1,"terrible crop yield,  bad net yield,  regenerativeagriculture,  companionplanting"
397,19,11,26,1.4,15,0,"commendable crop yield,  bad net yield,  pestcontrol,  naturalpestmanagement,  croprotation"
398,22,10,23,1,13,1,"terrible crop yield,  good net yield,  croprotation,  sustainableagriculture"
399,23,6,18,0.8,12,0,"needs crop improvement,  bad net yield,  naturalpestmanagement,  companionplanting,  greenhousegrowing"
400,22,4,21,1,17,1,"terrible crop yield,  excellent net yield,  soilmanagement,  irrigation,  vermiculture"
401,14,16,2,0.1,-14,1,"terrible crop yield,  bad net yield,  regenerativeagriculture,  companionplanting"
402,6,19,11,1.8,-8,1,"terrible crop yield,  bad net yield,  greenhousegrowing,  sustainableagriculture"
403,6,8,9,1.5,1,1,"terrible crop yield,  bad net yield,  precisionfarming,  sustainableagriculture"
404,13,13,19,1.5,6,1,"terrible crop yield,  bad net yield,  naturalpestmanagement,  croprotation"
405,19,11,29,1.5,18,1,"terrible crop yield,  excellent net yield,  pestcontrol,  croprotation,  naturalpestmanagement"
406,22,5,2,0.1,-3,1,"terrible crop yield,  bad net yield,  greenhousegrowing,  pestcontrol,  companionplanting"
407,8,16,22,2.8,6,0,"commendable crop yield,  bad net yield,  companionplanting,  regenerativeagriculture"
408,27,18,13,0.5,-5,0,"needs crop improvement,  bad net yield,  sustainableagriculture,  greenhousegrowing"
409,27,18,21,0.8,3,0,"needs crop improvement,  bad net yield,  sustainableagriculture,  greenhousegrowing"
410,2,15,16,8,1,0,"commendable crop yield,  bad net yield,  regenerativeagriculture,  companionplanting"
411,21,11,28,1.3,17,0,"commendable crop yield,  bad net yield,  naturalpestmanagement,  croprotation"
412,1,11,2,2,-9,1,"needs improvement,  bad net yield,  croprotation,  pestcontrol,  naturalpestmanagement"
413,28,19,14,0.5,-5,1,"terrible crop yield,  bad net yield,  greenhousegrowing,  sustainableagriculture"
414,15,5,10,0.7,5,0,"needs crop improvement,  bad net yield,  companionplanting,  precisionfarming"
415,1,3,27,27,24,1,"commendable crop yield,  excellent net yield,  fertilization,  organicfarming"
416,5,5,17,3.4,12,0,"commendable crop yield,  excellent net yield,  pestcontrol,  covercrops,  greenhousegrowing"
417,28,10,8,0.3,-2,0,"needs crop improvement,  bad net yield,  sustainableagriculture,  companionplanting"
418,29,0,3,0.1,3,1,"terrible crop yield, bad net yield, greenhousegrowing, precisionfarming"
419,16,14,7,0.4,-7,1,"terrible crop yield,  bad net yield,  regenerativeagriculture,  companionplanting"
420,19,10,8,0.4,-2,1,"terrible crop yield,  bad net yield,  naturalpestmanagement,  greenhousegrowing,  precisionfarming"
421,4,18,25,6.3,7,0,"commendable crop yield,  excellent net yield,  sustainableagriculture,  greenhousegrowing"
422,3,17,15,5,-2,1,"average crop yield,  bad net yield,  regenerativeagriculture,  companionplanting"
423,17,16,27,1.6,11,0,"commendable crop yield,  bad net yield,  regenerativeagriculture,  companionplanting"
424,17,18,14,0.8,-4,0,"needs crop improvement,  bad net yield,  greenhousegrowing,  sustainableagriculture"
425,12,13,28,2.3,15,0,"commendable crop yield,  excellent net yield,  pestcontrol,  naturalpestmanagement"
426,28,17,3,0.1,-14,1,"terrible crop yield,  bad net yield,  regenerativeagriculture,  companionplanting"
427,29,18,11,0.4,-7,1,"terrible crop yield,  bad net yield,  sustainableagriculture,  greenhousegrowing"
428,14,14,18,1.3,4,0,"commendable crop yield,  bad net yield,  regenerativeagriculture,  companionplanting"
429,21,14,13,0.6,-1,1,"terrible crop yield,  bad net yield,  regenerativeagriculture,  companionplanting"
430,6,3,18,3,15,1,"needs improvement,  good net yield,  irrigation,  organicfarming"
431,3,6,9,3,3,1,"needs improvement,  bad net yield,  covercrops,  sustainableagriculture,  pestcontrol"
432,28,12,21,0.8,9,0,"needs crop improvement,  bad net yield,  naturalpestmanagement,  pestcontrol"
433,9,2,12,1.3,10,0,"commendable crop yield,  excellent net yield,  irrigation,  organicfarming,  soilmanagement"
434,5,15,4,0.8,-11,1,"terrible crop yield,  bad net yield,  regenerativeagriculture,  companionplanting"
435,24,8,14,0.6,6,0,"needs crop improvement,  bad net yield,  sustainableagriculture,  greenhousegrowing"
436,29,7,7,0.2,0,1,"terrible crop yield,  bad net yield,  sustainableagriculture,  precisionfarming"
437,17,19,10,0.6,-9,1,"terrible crop yield,  bad net yield,  sustainableagriculture,  greenhousegrowing"
438,14,12,7,0.5,-5,1,"terrible crop yield,  bad net yield,  naturalpestmanagement,  pestcontrol,  croprotation"
439,21,16,10,0.5,-6,1,"terrible crop yield,  bad net yield,  companionplanting,  regenerativeagriculture"
440,3,16,26,8.7,10,0,"commendable crop yield,  excellent net yield,  regenerativeagriculture,  companionplanting"
441,28,16,23,0.8,7,0,"needs crop improvement,  bad net yield,  regenerativeagriculture,  companionplanting"
442,1,0,7,7,7,0,"commendable crop yield,  excellent net yield,  foodsecurity,  localfood"
443,20,7,13,0.7,6,1,"terrible crop yield,  bad net yield,  croprotation,  naturalpestmanagement"
444,29,18,9,0.3,-9,1,"terrible crop yield,  bad net yield,  greenhousegrowing,  sustainableagriculture"
445,21,5,9,0.4,4,1,"terrible crop yield,  bad net yield,  greenhousegrowing,  companionplanting"
446,23,2,15,0.7,13,0,"needs crop improvement,  bad net yield,  organicfarming,  fertilization,  vermiculture"
447,1,4,29,29,25,1,"commendable crop yield,  excellent net yield,  fertilization,  pollinatorfriendly"
448,3,12,21,7,9,0,"commendable crop yield,  excellent net yield,  croprotation,  naturalpestmanagement"
449,18,14,13,0.7,-1,0,"needs crop improvement,  bad net yield,  regenerativeagriculture,  companionplanting"
450,25,13,21,0.8,8,0,"needs crop improvement,  bad net yield,  pestcontrol,  croprotation,  naturalpestmanagement"
451,10,15,8,0.8,-7,0,"needs crop improvement,  bad net yield,  regenerativeagriculture,  companionplanting"
452,22,17,14,0.6,-3,0,"needs crop improvement,  bad net yield,  regenerativeagriculture,  companionplanting"
453,26,10,8,0.3,-2,0,"needs crop improvement,  bad net yield,  greenhousegrowing,  croprotation"
454,3,2,17,5.7,15,1,"average crop yield,  good net yield,  organicfarming,  pollinatorfriendly"
455,8,9,5,0.6,-4,1,"terrible crop yield,  bad net yield,  precisionfarming,  covercrops"
456,14,9,23,1.6,14,0,"commendable crop yield,  good net yield,  covercrops,  croprotation,  greenhousegrowing"
457,24,15,12,0.5,-3,0,"needs crop improvement,  bad net yield,  companionplanting,  regenerativeagriculture"
458,18,11,23,1.3,12,1,"terrible crop yield,  good net yield,  croprotation,  naturalpestmanagement,  pestcontrol"
459,15,1,22,1.5,21,0,"commendable crop yield,  excellent net yield,  irrigation,  organicfarming,  fertilization"
460,22,8,22,1,14,0,"average crop yield,  bad net yield,  covercrops,  sustainableagriculture,  precisionfarming"
461,23,2,10,0.4,8,1,"terrible crop yield,  bad net yield,  organicfarming,  soilmanagement,  irrigation"
462,2,14,25,12.5,11,0,"commendable crop yield,  excellent net yield,  companionplanting,  regenerativeagriculture"
463,27,2,22,0.8,20,0,"needs crop improvement,  bad net yield,  soilmanagement,  organicfarming,  pollinatorfriendly"
464,10,18,28,2.8,10,0,"commendable crop yield,  good net yield,  greenhousegrowing,  sustainableagriculture"
465,2,17,12,6,-5,1,"average crop yield,  bad net yield,  regenerativeagriculture,  companionplanting"
466,26,7,19,0.7,12,1,"terrible crop yield,  good net yield,  greenhousegrowing,  naturalpestmanagement"
467,17,16,23,1.4,7,1,"terrible crop yield,  bad net yield,  companionplanting,  regenerativeagriculture"
468,8,7,2,0.3,-5,0,"needs crop improvement,  bad net yield,  greenhousegrowing,  companionplanting"
469,1,6,29,29,23,0,"commendable crop yield,  excellent net yield,  sustainableagriculture,  pestcontrol,  covercrops"
470,9,6,13,1.4,7,1,"terrible crop yield,  bad net yield,  precisionfarming,  pestcontrol"
471,11,2,15,1.4,13,0,"commendable crop yield,  excellent net yield,  fertilization,  soilmanagement"
472,22,0,20,0.9,20,0,"needs crop improvement, bad net yield, sustainablepractices, raisedbeds"
473,16,3,27,1.7,24,0,"commendable crop yield,  excellent net yield,  organicfarming,  soilmanagement"
474,7,4,18,2.6,14,0,"commendable crop yield,  excellent net yield,  soilmanagement,  vermiculture"
475,29,0,15,0.5,15,0,"needs crop improvement, bad net yield, mulching, composting, sustainablepractices"
476,10,14,20,2,6,1,"needs improvement,  bad net yield,  companionplanting,  regenerativeagriculture"
477,23,4,23,1,19,0,"average crop yield,  bad net yield,  pollinatorfriendly,  soilmanagement"
478,26,12,15,0.6,3,1,"terrible crop yield,  bad net yield,  pestcontrol,  naturalpestmanagement,  croprotation"
479,3,7,12,4,5,0,"commendable crop yield,  excellent net yield,  pestcontrol,  precisionfarming,  covercrops"
480,18,7,14,0.8,7,1,"terrible crop yield,  bad net yield,  greenhousegrowing,  sustainableagriculture"
481,25,4,22,0.9,18,0,"needs crop improvement,  bad net yield,  organicfarming,  soilmanagement"
482,24,8,30,1.3,22,1,"terrible crop yield,  excellent net yield,  precisionfarming,  sustainableagriculture,  companionplanting"
483,13,0,5,0.4,5,0,"needs crop improvement, bad net yield, covercrops, companionplanting"
484,28,3,22,0.8,19,1,"terrible crop yield,  excellent net yield,  organicfarming,  soilmanagement"
485,26,2,1,0,-1,0,"needs crop improvement,  bad net yield,  vermiculture,  soilmanagement"
486,7,1,20,2.9,19,1,"needs improvement,  excellent net yield,  organicfarming,  vermiculture"
487,25,7,3,0.1,-4,0,"needs crop improvement,  bad net yield,  naturalpestmanagement,  companionplanting"
488,4,8,19,4.8,11,1,"needs improvement,  good net yield,  greenhousegrowing,  covercrops,  sustainableagriculture"
489,13,1,7,0.5,6,1,"terrible crop yield,  bad net yield,  pollinatorfriendly,  organicfarming"
490,20,13,23,1.2,10,0,"commendable crop yield,  bad net yield,  naturalpestmanagement,  pestcontrol"
491,1,13,29,29,16,0,"commendable crop yield,  excellent net yield,  croprotation,  pestcontrol,  naturalpestmanagement"
492,8,3,23,2.9,20,1,"needs improvement,  excellent net yield,  soilmanagement,  pollinatorfriendly"
493,14,5,12,0.9,7,0,"needs crop improvement,  bad net yield,  companionplanting,  covercrops,  greenhousegrowing"
494,16,10,25,1.6,15,1,"terrible crop yield,  good net yield,  pestcontrol,  precisionfarming,  covercrops"
495,14,2,10,0.7,8,1,"terrible crop yield,  bad net yield,  pollinatorfriendly,  soilmanagement"
496,12,7,28,2.3,21,1,"needs improvement,  excellent net yield,  companionplanting,  naturalpestmanagement,  greenhousegrowing"
497,19,2,15,0.8,13,0,"needs crop improvement,  bad net yield,  soilmanagement,  pollinatorfriendly,  fertilization"
498,23,13,29,1.3,16,1,"terrible crop yield,  excellent net yield,  naturalpestmanagement,  croprotation"
499,15,12,11,0.7,-1,1,"terrible crop yield,  bad net yield,  pestcontrol,  croprotation,  naturalpestmanagement"
500,28,12,26,0.9,14,0,"needs crop improvement,  bad net yield,  croprotation,  naturalpestmanagement"
501,2,1,16,8,15,0,"commendable crop yield,  excellent net yield,  soilmanagement,  fertilization"
502,2,12,8,4,-4,0,"commendable crop yield,  bad net yield,  naturalpestmanagement,  pestcontrol,  croprotation"
503,23,18,1,0,-17,0,"needs crop improvement,  bad net yield,  greenhousegrowing,  sustainableagriculture"
504,22,5,23,1,18,1,"terrible crop yield,  excellent net yield,  croprotation,  naturalpestmanagement,  greenhousegrowing"
505,19,15,16,0.8,1,1,"terrible crop yield,  bad net yield,  companionplanting,  regenerativeagriculture"
506,25,1,2,0.1,1,1,"terrible crop yield,  bad net yield,  irrigation,  pollinatorfriendly,  organicfarming"
507,26,7,8,0.3,1,1,"terrible crop yield,  bad net yield,  pestcontrol,  precisionfarming,  greenhousegrowing"
508,29,16,4,0.1,-12,0,"needs crop improvement,  bad net yield,  regenerativeagriculture,  companionplanting"
509,22,1,18,0.8,17,1,"terrible crop yield,  excellent net yield,  organicfarming,  soilmanagement"
510,26,9,22,0.8,13,1,"terrible crop yield,  good net yield,  sustainableagriculture,  precisionfarming"
511,26,15,10,0.4,-5,0,"needs crop improvement,  bad net yield,  companionplanting,  regenerativeagriculture"
512,22,5,30,1.4,25,1,"terrible crop yield,  excellent net yield,  covercrops,  sustainableagriculture,  croprotation"
513,17,1,25,1.5,24,1,"terrible crop yield,  excellent net yield,  fertilization,  pollinatorfriendly"
514,20,1,21,1.1,20,1,"terrible crop yield,  excellent net yield,  fertilization,  pollinatorfriendly,  vermiculture"
515,10,12,6,0.6,-6,1,"terrible crop yield,  bad net yield,  croprotation,  pestcontrol,  naturalpestmanagement"
516,6,14,5,0.8,-9,1,"terrible crop yield,  bad net yield,  companionplanting,  regenerativeagriculture"
517,15,1,29,1.9,28,1,"terrible crop yield,  excellent net yield,  soilmanagement,  vermiculture"
518,22,6,7,0.3,1,0,"needs crop improvement,  bad net yield,  companionplanting,  greenhousegrowing"
519,11,2,27,2.5,25,0,"commendable crop yield,  excellent net yield,  soilmanagement,  pollinatorfriendly,  vermiculture"
520,28,7,29,1,22,1,"terrible crop yield,  excellent net yield,  sustainableagriculture,  greenhousegrowing,  precisionfarming"
521,5,13,25,5,12,1,"average crop yield,  good net yield,  croprotation,  pestcontrol"
522,1,6,9,9,3,0,"commendable crop yield,  excellent net yield,  covercrops,  naturalpestmanagement,  precisionfarming"
523,8,6,18,2.3,12,1,"needs improvement,  good net yield,  sustainableagriculture,  covercrops"
524,21,0,20,1,20,1,"terrible crop yield, excellent net yield, covercrops, precisionfarming"
525,28,16,10,0.4,-6,1,"terrible crop yield,  bad net yield,  companionplanting,  regenerativeagriculture"
526,12,8,20,1.7,12,0,"commendable crop yield,  good net yield,  companionplanting,  sustainableagriculture,  precisionfarming"
527,12,12,27,2.3,15,1,"needs improvement,  good net yield,  pestcontrol,  croprotation,  naturalpestmanagement"
528,5,18,22,4.4,4,0,"commendable crop yield,  bad net yield,  sustainableagriculture,  greenhousegrowing"
529,7,18,3,0.4,-15,1,"terrible crop yield,  bad net yield,  greenhousegrowing,  sustainableagriculture"
530,4,16,26,6.5,10,0,"commendable crop yield,  excellent net yield,  regenerativeagriculture,  companionplanting"
531,6,9,26,4.3,17,0,"commendable crop yield,  excellent net yield,  pestcontrol,  greenhousegrowing"
532,13,9,16,1.2,7,1,"terrible crop yield,  bad net yield,  pestcontrol,  precisionfarming,  sustainableagriculture"
533,20,3,12,0.6,9,0,"needs crop improvement,  bad net yield,  soilmanagement,  fertilization"
534,15,7,5,0.3,-2,1,"terrible crop yield,  bad net yield,  precisionfarming,  companionplanting"
535,3,19,14,4.7,-5,0,"commendable crop yield,  bad net yield,  sustainableagriculture,  greenhousegrowing"
536,23,19,8,0.3,-11,1,"terrible crop yield,  bad net yield,  sustainableagriculture,  greenhousegrowing"
537,8,17,11,1.4,-6,1,"terrible crop yield,  bad net yield,  regenerativeagriculture,  companionplanting"
538,20,13,2,0.1,-11,0,"needs crop improvement,  bad net yield,  croprotation,  pestcontrol,  naturalpestmanagement"
539,16,17,20,1.3,3,1,"terrible crop yield,  bad net yield,  companionplanting,  regenerativeagriculture"
540,13,13,27,2.1,14,1,"needs improvement,  good net yield,  naturalpestmanagement,  pestcontrol,  croprotation"
541,18,19,20,1.1,1,0,"commendable crop yield,  bad net yield,  greenhousegrowing,  sustainableagriculture"
542,28,14,30,1.1,16,1,"terrible crop yield,  excellent net yield,  companionplanting,  regenerativeagriculture"
543,10,3,13,1.3,10,1,"terrible crop yield,  good net yield,  fertilization,  pollinatorfriendly"
544,19,12,19,1,7,0,"average crop yield,  bad net yield,  pestcontrol,  naturalpestmanagement,  croprotation"
545,17,7,23,1.4,16,0,"commendable crop yield,  bad net yield,  companionplanting,  precisionfarming"
546,24,17,19,0.8,2,1,"terrible crop yield,  bad net yield,  regenerativeagriculture,  companionplanting"
547,19,11,9,0.5,-2,1,"terrible crop yield,  bad net yield,  pestcontrol,  croprotation"
548,28,13,19,0.7,6,0,"needs crop improvement,  bad net yield,  naturalpestmanagement,  pestcontrol,  croprotation"
549,26,1,5,0.2,4,0,"needs crop improvement,  bad net yield,  organicfarming,  soilmanagement"
550,23,17,2,0.1,-15,1,"terrible crop yield,  bad net yield,  regenerativeagriculture,  companionplanting"
551,26,1,4,0.2,3,0,"needs crop improvement,  bad net yield,  organicfarming,  irrigation,  fertilization"
552,5,10,27,5.4,17,1,"average crop yield,  excellent net yield,  companionplanting,  pestcontrol,  naturalpestmanagement"
553,26,8,9,0.3,1,1,"terrible crop yield,  bad net yield,  croprotation,  companionplanting,  naturalpestmanagement"
554,21,11,5,0.2,-6,1,"terrible crop yield,  bad net yield,  croprotation,  naturalpestmanagement"
555,23,16,17,0.7,1,1,"terrible crop yield,  bad net yield,  regenerativeagriculture,  companionplanting"
556,9,14,24,2.7,10,1,"needs improvement,  good net yield,  regenerativeagriculture,  companionplanting"
557,12,16,24,2,8,0,"commendable crop yield,  bad net yield,  companionplanting,  regenerativeagriculture"
558,21,17,22,1,5,0,"average crop yield,  bad net yield,  companionplanting,  regenerativeagriculture"
559,1,5,3,3,-2,0,"commendable crop yield,  bad net yield,  companionplanting,  naturalpestmanagement,  greenhousegrowing"
560,26,16,26,1,10,0,"average crop yield,  bad net yield,  regenerativeagriculture,  companionplanting"
561,26,17,3,0.1,-14,1,"terrible crop yield,  bad net yield,  companionplanting,  regenerativeagriculture"
562,1,7,24,24,17,1,"commendable crop yield,  excellent net yield,  pestcontrol,  sustainableagriculture,  covercrops"
563,15,8,6,0.4,-2,1,"terrible crop yield,  bad net yield,  sustainableagriculture,  covercrops,  precisionfarming"
564,2,5,6,3,1,1,"needs improvement,  bad net yield,  greenhousegrowing,  pestcontrol"
565,22,4,8,0.4,4,0,"needs crop improvement,  bad net yield,  fertilization,  vermiculture,  irrigation"
566,16,11,14,0.9,3,1,"terrible crop yield,  bad net yield,  naturalpestmanagement,  pestcontrol"
567,25,10,10,0.4,0,1,"terrible crop yield,  bad net yield,  croprotation,  companionplanting"
568,8,0,10,1.3,10,0,"commendable crop yield,  excellent net yield,  foodsecurity,  farmersmarket,  localfood"
569,13,10,6,0.5,-4,0,"needs crop improvement,  bad net yield,  greenhousegrowing,  naturalpestmanagement,  companionplanting"
570,21,18,14,0.7,-4,0,"needs crop improvement,  bad net yield,  greenhousegrowing,  sustainableagriculture"
571,1,8,4,4,-4,0,"commendable crop yield,  bad net yield,  greenhousegrowing,  naturalpestmanagement"
572,16,1,15,0.9,14,1,"terrible crop yield,  good net yield,  vermiculture,  irrigation"
573,29,11,25,0.9,14,1,"terrible crop yield,  good net yield,  naturalpestmanagement,  pestcontrol,  croprotation"
574,7,3,13,1.9,10,0,"commendable crop yield,  excellent net yield,  fertilization,  irrigation,  vermiculture"
575,5,3,26,5.2,23,1,"average crop yield,  excellent net yield,  vermiculture,  fertilization,  pollinatorfriendly"
576,22,17,21,1,4,1,"terrible crop yield,  bad net yield,  regenerativeagriculture,  companionplanting"
577,29,14,3,0.1,-11,1,"terrible crop yield,  bad net yield,  regenerativeagriculture,  companionplanting"
578,23,18,7,0.3,-11,0,"needs crop improvement,  bad net yield,  greenhousegrowing,  sustainableagriculture"
579,3,12,7,2.3,-5,1,"needs improvement,  bad net yield,  pestcontrol,  croprotation"
580,12,18,29,2.4,11,0,"commendable crop yield,  bad net yield,  greenhousegrowing,  sustainableagriculture"
581,26,16,28,1.1,12,1,"terrible crop yield,  good net yield,  regenerativeagriculture,  companionplanting"
582,16,5,26,1.6,21,1,"terrible crop yield,  excellent net yield,  covercrops,  greenhousegrowing,  croprotation"
583,19,15,26,1.4,11,1,"terrible crop yield,  good net yield,  companionplanting,  regenerativeagriculture"
584,5,11,5,1,-6,0,"average crop yield,  bad net yield,  naturalpestmanagement,  pestcontrol"
585,22,18,3,0.1,-15,1,"terrible crop yield,  bad net yield,  sustainableagriculture,  greenhousegrowing"
586,25,4,26,1,22,0,"average crop yield,  bad net yield,  organicfarming,  soilmanagement,  pollinatorfriendly"
587,29,16,23,0.8,7,0,"needs crop improvement,  bad net yield,  companionplanting,  regenerativeagriculture"
588,14,0,20,1.4,20,0,"commendable crop yield,  excellent net yield,  farmtofork,  localfood,  foodsecurity"
589,28,9,2,0.1,-7,1,"terrible crop yield,  bad net yield,  precisionfarming,  greenhousegrowing,  croprotation"
590,5,14,9,1.8,-5,1,"terrible crop yield,  bad net yield,  regenerativeagriculture,  companionplanting"
591,15,10,13,0.9,3,1,"terrible crop yield,  bad net yield,  naturalpestmanagement,  precisionfarming"
592,17,12,25,1.5,13,1,"terrible crop yield,  good net yield,  naturalpestmanagement,  pestcontrol,  croprotation"
593,14,4,18,1.3,14,0,"commendable crop yield,  good net yield,  vermiculture,  pollinatorfriendly,  irrigation"
594,20,0,19,1,19,0,"average crop yield,  bad net yield,  companionplanting,  naturalpestmanagement"
595,5,11,28,5.6,17,0,"commendable crop yield,  excellent net yield,  pestcontrol,  naturalpestmanagement,  croprotation"
596,12,10,16,1.3,6,1,"terrible crop yield,  bad net yield,  pestcontrol,  precisionfarming,  sustainableagriculture"
597,16,16,19,1.2,3,0,"commendable crop yield,  bad net yield,  regenerativeagriculture,  companionplanting"
598,26,3,11,0.4,8,1,"terrible crop yield,  bad net yield,  irrigation,  organicfarming"
599,26,14,14,0.5,0,0,"needs crop improvement,  bad net yield,  regenerativeagriculture,  companionplanting"
600,16,8,23,1.4,15,1,"terrible crop yield,  good net yield,  croprotation,  naturalpestmanagement,  covercrops"
601,21,19,15,0.7,-4,1,"terrible crop yield,  bad net yield,  sustainableagriculture,  greenhousegrowing"
602,7,18,24,3.4,6,0,"commendable crop yield,  bad net yield,  greenhousegrowing,  sustainableagriculture"
603,4,18,13,3.3,-5,0,"commendable crop yield,  bad net yield,  sustainableagriculture,  greenhousegrowing"
604,1,11,12,12,1,0,"commendable crop yield,  good net yield,  croprotation,  naturalpestmanagement,  pestcontrol"
605,5,4,26,5.2,22,0,"commendable crop yield,  excellent net yield,  pollinatorfriendly,  organicfarming,  soilmanagement"
606,23,9,13,0.6,4,1,"terrible crop yield,  bad net yield,  precisionfarming,  naturalpestmanagement"
607,26,16,21,0.8,5,0,"needs crop improvement,  bad net yield,  regenerativeagriculture,  companionplanting"
608,10,4,4,0.4,0,0,"needs crop improvement,  bad net yield,  fertilization,  pollinatorfriendly"
609,22,15,19,0.9,4,0,"needs crop improvement,  bad net yield,  companionplanting,  regenerativeagriculture"
610,5,6,21,4.2,15,1,"needs improvement,  good net yield,  precisionfarming,  naturalpestmanagement,  sustainableagriculture"
611,4,8,9,2.3,1,1,"needs improvement,  bad net yield,  croprotation,  sustainableagriculture,  pestcontrol"
612,2,2,4,2,2,0,"commendable crop yield,  good net yield,  vermiculture,  soilmanagement"
613,20,14,13,0.7,-1,1,"terrible crop yield,  bad net yield,  companionplanting,  regenerativeagriculture"
614,10,15,17,1.7,2,0,"commendable crop yield,  bad net yield,  companionplanting,  regenerativeagriculture"
615,26,17,26,1,9,1,"terrible crop yield,  good net yield,  companionplanting,  regenerativeagriculture"
616,19,13,23,1.2,10,1,"terrible crop yield,  good net yield,  croprotation,  naturalpestmanagement"
617,26,2,21,0.8,19,1,"terrible crop yield,  excellent net yield,  irrigation,  organicfarming"
618,1,11,29,29,18,1,"commendable crop yield,  excellent net yield,  naturalpestmanagement,  croprotation,  pestcontrol"
619,24,8,17,0.7,9,0,"needs crop improvement,  bad net yield,  precisionfarming,  croprotation"
620,5,6,27,5.4,21,0,"commendable crop yield,  excellent net yield,  pestcontrol,  covercrops,  naturalpestmanagement"
621,13,8,28,2.2,20,0,"commendable crop yield,  excellent net yield,  greenhousegrowing,  precisionfarming"
622,4,12,16,4,4,1,"needs improvement,  bad net yield,  pestcontrol,  naturalpestmanagement"
623,16,17,15,0.9,-2,0,"needs crop improvement,  bad net yield,  companionplanting,  regenerativeagriculture"
624,24,4,11,0.5,7,0,"needs crop improvement,  bad net yield,  vermiculture,  organicfarming,  fertilization"
625,16,12,25,1.6,13,0,"commendable crop yield,  bad net yield,  pestcontrol,  croprotation,  naturalpestmanagement"
626,23,3,18,0.8,15,1,"terrible crop yield,  good net yield,  soilmanagement,  irrigation"
627,2,1,18,9,17,1,"good crop yield,  excellent net yield,  pollinatorfriendly,  fertilization,  organicfarming"
628,17,15,25,1.5,10,1,"terrible crop yield,  good net yield,  regenerativeagriculture,  companionplanting"
629,28,8,1,0,-7,0,"needs crop improvement,  bad net yield,  covercrops,  naturalpestmanagement,  croprotation"
630,27,8,17,0.6,9,0,"needs crop improvement,  bad net yield,  pestcontrol,  covercrops,  naturalpestmanagement"
631,20,5,6,0.3,1,0,"needs crop improvement,  bad net yield,  greenhousegrowing,  pestcontrol,  sustainableagriculture"
632,24,10,16,0.7,6,1,"terrible crop yield,  bad net yield,  greenhousegrowing,  naturalpestmanagement,  precisionfarming"
633,12,0,16,1.3,16,1,"terrible crop yield, excellent net yield, sustainableagriculture, precisionfarming"
634,18,3,16,0.9,13,0,"needs crop improvement,  bad net yield,  irrigation,  vermiculture,  pollinatorfriendly"
635,3,12,13,4.3,1,1,"needs improvement,  bad net yield,  naturalpestmanagement,  pestcontrol,  croprotation"
636,28,12,28,1,16,1,"terrible crop yield,  excellent net yield,  croprotation,  naturalpestmanagement"
637,1,12,30,30,18,1,"commendable crop yield,  excellent net yield,  croprotation,  pestcontrol"
638,1,1,21,21,20,1,"commendable crop yield,  excellent net yield,  pollinatorfriendly,  fertilization,  vermiculture"
639,29,8,15,0.5,7,0,"needs crop improvement,  bad net yield,  covercrops,  naturalpestmanagement,  precisionfarming"
640,19,7,15,0.8,8,1,"terrible crop yield,  bad net yield,  companionplanting,  covercrops"
641,11,6,3,0.3,-3,1,"terrible crop yield,  bad net yield,  pestcontrol,  companionplanting,  greenhousegrowing"
642,5,3,10,2,7,1,"needs improvement,  bad net yield,  fertilization,  irrigation,  pollinatorfriendly"
643,12,17,6,0.5,-11,1,"terrible crop yield,  bad net yield,  companionplanting,  regenerativeagriculture"
644,3,2,9,3,7,0,"commendable crop yield,  excellent net yield,  pollinatorfriendly,  organicfarming"
645,1,5,26,26,21,0,"commendable crop yield,  excellent net yield,  croprotation,  precisionfarming"
646,1,11,30,30,19,1,"commendable crop yield,  excellent net yield,  croprotation,  pestcontrol"
647,8,11,2,0.3,-9,1,"terrible crop yield,  bad net yield,  naturalpestmanagement,  pestcontrol"
648,10,7,24,2.4,17,1,"needs improvement,  excellent net yield,  greenhousegrowing,  sustainableagriculture,  croprotation"
649,11,0,4,0.4,4,1,"terrible crop yield, bad net yield, greenhousegrowing, sustainableagriculture"
650,12,3,7,0.6,4,1,"terrible crop yield,  bad net yield,  organicfarming,  pollinatorfriendly,  vermiculture"
651,29,10,6,0.2,-4,1,"terrible crop yield,  bad net yield,  precisionfarming,  covercrops"
652,13,2,18,1.4,16,0,"commendable crop yield,  excellent net yield,  vermiculture,  organicfarming,  soilmanagement"
653,12,12,28,2.3,16,1,"needs improvement,  excellent net yield,  pestcontrol,  naturalpestmanagement"
654,14,16,13,0.9,-3,0,"needs crop improvement,  bad net yield,  regenerativeagriculture,  companionplanting"
655,2,9,11,5.5,2,0,"commendable crop yield,  good net yield,  covercrops,  greenhousegrowing"
656,29,11,18,0.6,7,1,"terrible crop yield,  bad net yield,  croprotation,  naturalpestmanagement"
657,19,14,22,1.2,8,0,"commendable crop yield,  bad net yield,  regenerativeagriculture,  companionplanting"
658,18,9,13,0.7,4,0,"needs crop improvement,  bad net yield,  covercrops,  companionplanting"
659,3,13,6,2,-7,0,"commendable crop yield,  bad net yield,  pestcontrol,  croprotation"
660,23,12,17,0.7,5,0,"needs crop improvement,  bad net yield,  croprotation,  pestcontrol"
661,17,4,27,1.6,23,0,"commendable crop yield,  excellent net yield,  irrigation,  fertilization,  vermiculture"
662,26,5,13,0.5,8,0,"needs crop improvement,  bad net yield,  greenhousegrowing,  pestcontrol"
663,8,1,19,2.4,18,1,"needs improvement,  excellent net yield,  irrigation,  soilmanagement"
664,29,16,21,0.7,5,0,"needs crop improvement,  bad net yield,  companionplanting,  regenerativeagriculture"
665,26,3,19,0.7,16,0,"needs crop improvement,  bad net yield,  vermiculture,  irrigation"
666,10,13,10,1,-3,0,"average crop yield,  bad net yield,  pestcontrol,  croprotation"
667,26,9,3,0.1,-6,1,"terrible crop yield,  bad net yield,  precisionfarming,  sustainableagriculture,  croprotation"
668,2,2,14,7,12,0,"commendable crop yield,  excellent net yield,  organicfarming,  fertilization"
669,19,2,19,1,17,1,"terrible crop yield,  excellent net yield,  organicfarming,  vermiculture,  fertilization"
670,9,14,19,2.1,5,0,"commendable crop yield,  bad net yield,  regenerativeagriculture,  companionplanting"
671,7,5,26,3.7,21,1,"needs improvement,  excellent net yield,  croprotation,  greenhousegrowing,  precisionfarming"
672,4,16,8,2,-8,1,"needs improvement,  bad net yield,  companionplanting,  regenerativeagriculture"
673,26,11,5,0.2,-6,0,"needs crop improvement,  bad net yield,  pestcontrol,  naturalpestmanagement"
674,21,19,20,1,1,0,"average crop yield,  bad net yield,  greenhousegrowing,  sustainableagriculture"
675,18,10,12,0.7,2,1,"terrible crop yield,  bad net yield,  covercrops,  companionplanting,  croprotation"
676,13,3,21,1.6,18,0,"commendable crop yield,  excellent net yield,  vermiculture,  irrigation,  fertilization"
677,11,5,24,2.2,19,1,"needs improvement,  excellent net yield,  croprotation,  naturalpestmanagement,  greenhousegrowing"
678,29,0,13,0.4,13,1,"terrible crop yield, good net yield, permaculture, greenhousegrowing"
679,24,19,7,0.3,-12,1,"terrible crop yield,  bad net yield,  sustainableagriculture,  greenhousegrowing"
680,4,15,21,5.3,6,1,"average crop yield,  bad net yield,  regenerativeagriculture,  companionplanting"
681,25,14,24,1,10,1,"terrible crop yield,  good net yield,  regenerativeagriculture,  companionplanting"
682,21,16,4,0.2,-12,0,"needs crop improvement,  bad net yield,  regenerativeagriculture,  companionplanting"
683,29,7,21,0.7,14,1,"terrible crop yield,  good net yield,  covercrops,  companionplanting,  greenhousegrowing"
684,25,11,17,0.7,6,1,"terrible crop yield,  bad net yield,  naturalpestmanagement,  pestcontrol"
685,4,9,18,4.5,9,0,"commendable crop yield,  excellent net yield,  sustainableagriculture,  covercrops"
686,10,14,11,1.1,-3,1,"terrible crop yield,  bad net yield,  regenerativeagriculture,  companionplanting"
687,5,8,1,0.2,-7,0,"needs crop improvement,  bad net yield,  naturalpestmanagement,  precisionfarming"
688,9,1,24,2.7,23,0,"commendable crop yield,  excellent net yield,  irrigation,  soilmanagement"
689,24,4,25,1,21,0,"average crop yield,  bad net yield,  fertilization,  soilmanagement"
690,3,5,19,6.3,14,1,"average crop yield,  good net yield,  naturalpestmanagement,  croprotation"
691,17,6,22,1.3,16,1,"terrible crop yield,  excellent net yield,  precisionfarming,  covercrops"
692,3,0,2,0.7,2,1,"terrible crop yield, bad net yield, permaculture, covercrops"
693,16,6,22,1.4,16,0,"commendable crop yield,  good net yield,  companionplanting,  pestcontrol,  greenhousegrowing"
694,4,19,9,2.3,-10,1,"needs improvement,  bad net yield,  greenhousegrowing,  sustainableagriculture"
695,18,11,28,1.6,17,0,"commendable crop yield,  bad net yield,  naturalpestmanagement,  pestcontrol,  croprotation"
696,17,15,7,0.4,-8,1,"terrible crop yield,  bad net yield,  companionplanting,  regenerativeagriculture"
697,7,15,28,4,13,0,"commendable crop yield,  excellent net yield,  companionplanting,  regenerativeagriculture"
698,24,10,16,0.7,6,1,"terrible crop yield,  bad net yield,  croprotation,  sustainableagriculture,  greenhousegrowing"
699,23,3,23,1,20,1,"terrible crop yield,  excellent net yield,  vermiculture,  fertilization"
700,5,12,16,3.2,4,1,"needs improvement,  bad net yield,  pestcontrol,  croprotation"
701,12,6,25,2.1,19,0,"commendable crop yield,  excellent net yield,  covercrops,  sustainableagriculture"
702,17,3,4,0.2,1,0,"needs crop improvement,  bad net yield,  vermiculture,  soilmanagement"
703,23,14,24,1,10,1,"terrible crop yield,  good net yield,  regenerativeagriculture,  companionplanting"
704,13,18,24,1.8,6,1,"terrible crop yield,  bad net yield,  sustainableagriculture,  greenhousegrowing"
705,23,8,12,0.5,4,0,"needs crop improvement,  bad net yield,  pestcontrol,  sustainableagriculture,  croprotation"
706,25,10,10,0.4,0,0,"needs crop improvement,  bad net yield,  pestcontrol,  precisionfarming,  companionplanting"
707,3,7,22,7.3,15,0,"commendable crop yield,  excellent net yield,  greenhousegrowing,  covercrops,  pestcontrol"
708,9,0,19,2.1,19,1,"needs improvement, excellent net yield, greenhousegrowing, naturalpestmanagement"
709,17,7,7,0.4,0,0,"needs crop improvement,  bad net yield,  naturalpestmanagement,  greenhousegrowing,  precisionfarming"
710,17,12,18,1.1,6,1,"terrible crop yield,  bad net yield,  naturalpestmanagement,  croprotation,  pestcontrol"
711,20,3,23,1.2,20,0,"commendable crop yield,  good net yield,  vermiculture,  soilmanagement,  irrigation"
712,16,7,9,0.6,2,1,"terrible crop yield,  bad net yield,  sustainableagriculture,  covercrops,  greenhousegrowing"
713,25,2,14,0.6,12,0,"needs crop improvement,  bad net yield,  irrigation,  organicfarming"
714,22,8,24,1.1,16,0,"commendable crop yield,  bad net yield,  companionplanting,  covercrops,  precisionfarming"
715,13,1,10,0.8,9,0,"needs crop improvement,  bad net yield,  irrigation,  fertilization,  vermiculture"
716,27,1,16,0.6,15,0,"needs crop improvement,  bad net yield,  vermiculture,  pollinatorfriendly,  soilmanagement"
717,19,12,16,0.8,4,0,"needs crop improvement,  bad net yield,  croprotation,  pestcontrol,  naturalpestmanagement"
718,17,14,9,0.5,-5,1,"terrible crop yield,  bad net yield,  companionplanting,  regenerativeagriculture"
719,4,11,10,2.5,-1,0,"commendable crop yield,  bad net yield,  croprotation,  pestcontrol,  naturalpestmanagement"
720,12,3,25,2.1,22,0,"commendable crop yield,  excellent net yield,  fertilization,  vermiculture"
721,29,7,13,0.4,6,0,"needs crop improvement,  bad net yield,  naturalpestmanagement,  precisionfarming,  croprotation"
722,9,8,2,0.2,-6,1,"terrible crop yield,  bad net yield,  precisionfarming,  greenhousegrowing,  croprotation"
723,19,4,12,0.6,8,0,"needs crop improvement,  bad net yield,  soilmanagement,  fertilization,  vermiculture"
724,12,19,20,1.7,1,1,"terrible crop yield,  bad net yield,  greenhousegrowing,  sustainableagriculture"
725,9,17,13,1.4,-4,0,"commendable crop yield,  bad net yield,  regenerativeagriculture,  companionplanting"
726,7,10,4,0.6,-6,0,"needs crop improvement,  bad net yield,  precisionfarming,  naturalpestmanagement"
727,28,14,22,0.8,8,1,"terrible crop yield,  bad net yield,  regenerativeagriculture,  companionplanting"
728,14,8,11,0.8,3,0,"needs crop improvement,  bad net yield,  croprotation,  covercrops"
729,20,16,6,0.3,-10,1,"terrible crop yield,  bad net yield,  regenerativeagriculture,  companionplanting"
730,19,11,10,0.5,-1,1,"terrible crop yield,  bad net yield,  naturalpestmanagement,  pestcontrol"
731,26,6,26,1,20,0,"average crop yield,  bad net yield,  covercrops,  croprotation"
732,15,9,29,1.9,20,1,"terrible crop yield,  excellent net yield,  naturalpestmanagement,  precisionfarming"
733,16,9,25,1.6,16,0,"commendable crop yield,  good net yield,  naturalpestmanagement,  croprotation,  covercrops"
734,21,12,21,1,9,0,"average crop yield,  bad net yield,  croprotation,  pestcontrol,  naturalpestmanagement"
735,5,18,7,1.4,-11,1,"terrible crop yield,  bad net yield,  sustainableagriculture,  greenhousegrowing"
736,3,10,10,3.3,0,1,"needs improvement,  bad net yield,  naturalpestmanagement,  pestcontrol"
737,12,12,2,0.2,-10,1,"terrible crop yield,  bad net yield,  croprotation,  naturalpestmanagement"
738,25,7,10,0.4,3,1,"terrible crop yield,  bad net yield,  pestcontrol,  sustainableagriculture,  naturalpestmanagement"
739,20,7,7,0.4,0,0,"needs crop improvement,  bad net yield,  sustainableagriculture,  companionplanting"
740,27,3,6,0.2,3,0,"needs crop improvement,  bad net yield,  vermiculture,  fertilization,  soilmanagement"
741,21,14,14,0.7,0,1,"terrible crop yield,  bad net yield,  regenerativeagriculture,  companionplanting"
742,4,10,18,4.5,8,0,"commendable crop yield,  excellent net yield,  greenhousegrowing,  croprotation,  naturalpestmanagement"
743,21,10,24,1.1,14,0,"commendable crop yield,  bad net yield,  precisionfarming,  greenhousegrowing,  croprotation"
744,23,0,11,0.5,11,0,"needs crop improvement, bad net yield, waterconservation, sustainablepractices"
745,16,16,20,1.3,4,0,"commendable crop yield,  bad net yield,  companionplanting,  regenerativeagriculture"
746,25,14,12,0.5,-2,1,"terrible crop yield,  bad net yield,  regenerativeagriculture,  companionplanting"
747,7,19,5,0.7,-14,1,"terrible crop yield,  bad net yield,  sustainableagriculture,  greenhousegrowing"
748,13,5,16,1.2,11,0,"commendable crop yield,  bad net yield,  croprotation,  greenhousegrowing"
749,21,14,30,1.4,16,1,"terrible crop yield,  excellent net yield,  regenerativeagriculture,  companionplanting"
750,10,8,7,0.7,-1,1,"terrible crop yield,  bad net yield,  naturalpestmanagement,  sustainableagriculture,  companionplanting"
751,26,13,15,0.6,2,1,"terrible crop yield,  bad net yield,  croprotation,  pestcontrol,  naturalpestmanagement"
752,7,17,26,3.7,9,0,"commendable crop yield,  excellent net yield,  regenerativeagriculture,  companionplanting"
753,14,16,12,0.9,-4,0,"needs crop improvement,  bad net yield,  regenerativeagriculture,  companionplanting"
754,26,17,24,0.9,7,0,"needs crop improvement,  bad net yield,  regenerativeagriculture,  companionplanting"
755,5,4,7,1.4,3,1,"terrible crop yield,  bad net yield,  irrigation,  vermiculture"
756,3,19,25,8.3,6,0,"commendable crop yield,  excellent net yield,  sustainableagriculture,  greenhousegrowing"
757,23,19,5,0.2,-14,0,"needs crop improvement,  bad net yield,  sustainableagriculture,  greenhousegrowing"
758,29,8,14,0.5,6,1,"terrible crop yield,  bad net yield,  croprotation,  covercrops,  sustainableagriculture"
759,11,10,21,1.9,11,0,"commendable crop yield,  good net yield,  sustainableagriculture,  greenhousegrowing"
760,11,0,18,1.6,18,0,"commendable crop yield,  excellent net yield,  localfood,  farmersmarket,  farmtofork"
761,18,17,20,1.1,3,1,"terrible crop yield,  bad net yield,  regenerativeagriculture,  companionplanting"
762,15,5,14,0.9,9,1,"terrible crop yield,  good net yield,  naturalpestmanagement,  covercrops,  greenhousegrowing"
763,12,1,12,1,11,1,"terrible crop yield,  good net yield,  irrigation,  soilmanagement"
764,9,14,26,2.9,12,0,"commendable crop yield,  excellent net yield,  companionplanting,  regenerativeagriculture"
765,10,13,5,0.5,-8,0,"needs crop improvement,  bad net yield,  pestcontrol,  croprotation"
766,26,4,24,0.9,20,0,"needs crop improvement,  bad net yield,  fertilization,  pollinatorfriendly,  organicfarming"
767,12,5,8,0.7,3,1,"terrible crop yield,  bad net yield,  greenhousegrowing,  pestcontrol,  covercrops"
768,17,5,26,1.5,21,1,"terrible crop yield,  excellent net yield,  covercrops,  croprotation"
769,29,17,19,0.7,2,0,"needs crop improvement,  bad net yield,  regenerativeagriculture,  companionplanting"
770,6,13,25,4.2,12,0,"commendable crop yield,  excellent net yield,  naturalpestmanagement,  pestcontrol"
771,7,9,2,0.3,-7,1,"terrible crop yield,  bad net yield,  naturalpestmanagement,  croprotation"
772,14,13,13,0.9,0,1,"terrible crop yield,  bad net yield,  croprotation,  naturalpestmanagement,  pestcontrol"
773,13,12,27,2.1,15,1,"needs improvement,  good net yield,  croprotation,  naturalpestmanagement,  pestcontrol"
774,8,2,8,1,6,1,"terrible crop yield,  bad net yield,  fertilization,  organicfarming,  soilmanagement"
775,10,5,9,0.9,4,0,"needs crop improvement,  bad net yield,  pestcontrol,  covercrops"
776,9,7,22,2.4,15,1,"needs improvement,  good net yield,  sustainableagriculture,  croprotation"
777,18,11,18,1,7,0,"average crop yield,  bad net yield,  naturalpestmanagement,  croprotation,  pestcontrol"
778,27,12,21,0.8,9,0,"needs crop improvement,  bad net yield,  pestcontrol,  croprotation,  naturalpestmanagement"
779,26,10,4,0.2,-6,0,"needs crop improvement,  bad net yield,  pestcontrol,  croprotation,  precisionfarming"
780,2,11,26,13,15,1,"good crop yield,  good net yield,  pestcontrol,  naturalpestmanagement,  croprotation"
781,5,0,2,0.4,2,1,"terrible crop yield, bad net yield, precisionfarming, sustainableagriculture, greenhousegrowing"
782,29,16,18,0.6,2,1,"terrible crop yield,  bad net yield,  companionplanting,  regenerativeagriculture"
783,5,15,18,3.6,3,1,"needs improvement,  bad net yield,  regenerativeagriculture,  companionplanting"
784,6,10,23,3.8,13,0,"commendable crop yield,  excellent net yield,  companionplanting,  greenhousegrowing"
785,19,12,13,0.7,1,1,"terrible crop yield,  bad net yield,  croprotation,  pestcontrol,  naturalpestmanagement"
786,8,17,7,0.9,-10,1,"terrible crop yield,  bad net yield,  regenerativeagriculture,  companionplanting"
787,16,10,24,1.5,14,0,"commendable crop yield,  bad net yield,  sustainableagriculture,  pestcontrol,  greenhousegrowing"
788,13,11,12,0.9,1,1,"terrible crop yield,  bad net yield,  croprotation,  naturalpestmanagement"
789,1,5,29,29,24,0,"commendable crop yield,  excellent net yield,  pestcontrol,  greenhousegrowing"
790,22,8,2,0.1,-6,0,"needs crop improvement,  bad net yield,  pestcontrol,  covercrops"
791,20,15,28,1.4,13,0,"commendable crop yield,  bad net yield,  regenerativeagriculture,  companionplanting"
792,17,3,26,1.5,23,0,"commendable crop yield,  excellent net yield,  irrigation,  soilmanagement,  vermiculture"
793,7,2,11,1.6,9,0,"commendable crop yield,  excellent net yield,  soilmanagement,  pollinatorfriendly,  fertilization"
794,25,15,9,0.4,-6,0,"needs crop improvement,  bad net yield,  regenerativeagriculture,  companionplanting"
795,13,11,7,0.5,-4,0,"needs crop improvement,  bad net yield,  croprotation,  pestcontrol,  naturalpestmanagement"
796,4,10,22,5.5,12,0,"commendable crop yield,  excellent net yield,  greenhousegrowing,  sustainableagriculture"
797,4,4,4,1,0,1,"terrible crop yield,  bad net yield,  irrigation,  fertilization"
798,6,17,22,3.7,5,1,"needs improvement,  bad net yield,  regenerativeagriculture,  companionplanting"
799,28,18,27,1,9,1,"terrible crop yield,  good net yield,  greenhousegrowing,  sustainableagriculture"
800,19,5,9,0.5,4,1,"terrible crop yield,  bad net yield,  sustainableagriculture,  companionplanting"
801,29,17,14,0.5,-3,0,"needs crop improvement,  bad net yield,  companionplanting,  regenerativeagriculture"
802,12,5,3,0.3,-2,1,"terrible crop yield,  bad net yield,  naturalpestmanagement,  precisionfarming"
803,22,3,2,0.1,-1,0,"needs crop improvement,  bad net yield,  vermiculture,  irrigation"
804,7,11,29,4.1,18,1,"needs improvement,  excellent net yield,  croprotation,  naturalpestmanagement,  pestcontrol"
805,27,18,22,0.8,4,1,"terrible crop yield,  bad net yield,  greenhousegrowing,  sustainableagriculture"
806,10,1,30,3,29,1,"needs improvement,  excellent net yield,  soilmanagement,  irrigation"
807,26,16,5,0.2,-11,0,"needs crop improvement,  bad net yield,  regenerativeagriculture,  companionplanting"
808,19,10,26,1.4,16,1,"terrible crop yield,  excellent net yield,  naturalpestmanagement,  croprotation,  sustainableagriculture"
809,7,10,22,3.1,12,0,"commendable crop yield,  excellent net yield,  sustainableagriculture,  pestcontrol,  precisionfarming"
810,3,15,16,5.3,1,0,"commendable crop yield,  bad net yield,  regenerativeagriculture,  companionplanting"
811,13,1,3,0.2,2,1,"terrible crop yield,  bad net yield,  soilmanagement,  organicfarming"
812,13,1,17,1.3,16,1,"terrible crop yield,  excellent net yield,  pollinatorfriendly,  vermiculture,  soilmanagement"
813,18,7,6,0.3,-1,1,"terrible crop yield,  bad net yield,  pestcontrol,  sustainableagriculture,  precisionfarming"
814,28,12,2,0.1,-10,0,"needs crop improvement,  bad net yield,  naturalpestmanagement,  croprotation,  pestcontrol"
815,26,9,13,0.5,4,1,"terrible crop yield,  bad net yield,  pestcontrol,  croprotation,  naturalpestmanagement"
816,20,7,16,0.8,9,0,"needs crop improvement,  bad net yield,  naturalpestmanagement,  companionplanting,  pestcontrol"
817,28,3,19,0.7,16,0,"needs crop improvement,  bad net yield,  pollinatorfriendly,  soilmanagement"
818,8,14,12,1.5,-2,1,"terrible crop yield,  bad net yield,  regenerativeagriculture,  companionplanting"
819,29,0,17,0.6,17,1,"terrible crop yield, excellent net yield, precisionfarming, greenhousegrowing"
820,9,10,22,2.4,12,0,"commendable crop yield,  excellent net yield,  pestcontrol,  companionplanting,  naturalpestmanagement"
821,7,6,12,1.7,6,0,"commendable crop yield,  bad net yield,  greenhousegrowing,  croprotation,  companionplanting"
822,1,16,24,24,8,0,"commendable crop yield,  excellent net yield,  companionplanting,  regenerativeagriculture"
823,3,19,19,6.3,0,1,"average crop yield,  bad net yield,  sustainableagriculture,  greenhousegrowing"
824,13,17,8,0.6,-9,0,"needs crop improvement,  bad net yield,  regenerativeagriculture,  companionplanting"
825,28,11,28,1,17,1,"terrible crop yield,  excellent net yield,  pestcontrol,  naturalpestmanagement,  croprotation"
826,25,8,28,1.1,20,0,"commendable crop yield,  bad net yield,  sustainableagriculture,  pestcontrol,  greenhousegrowing"
827,28,4,27,1,23,0,"average crop yield,  bad net yield,  fertilization,  organicfarming"
828,17,9,22,1.3,13,1,"terrible crop yield,  good net yield,  croprotation,  sustainableagriculture,  companionplanting"
829,25,3,3,0.1,0,0,"needs crop improvement,  bad net yield,  soilmanagement,  pollinatorfriendly,  organicfarming"
830,24,4,12,0.5,8,1,"terrible crop yield,  bad net yield,  organicfarming,  fertilization"
831,1,9,24,24,15,1,"commendable crop yield,  good net yield,  croprotation,  pestcontrol,  naturalpestmanagement"
832,6,10,7,1.2,-3,0,"commendable crop yield,  bad net yield,  companionplanting,  croprotation,  precisionfarming"
833,21,9,16,0.8,7,1,"terrible crop yield,  bad net yield,  naturalpestmanagement,  sustainableagriculture"
834,6,7,22,3.7,15,1,"needs improvement,  good net yield,  naturalpestmanagement,  sustainableagriculture,  covercrops"
835,26,1,26,1,25,0,"average crop yield,  bad net yield,  organicfarming,  pollinatorfriendly,  soilmanagement"
836,12,7,16,1.3,9,1,"terrible crop yield,  good net yield,  sustainableagriculture,  pestcontrol"
837,13,15,26,2,11,1,"needs improvement,  good net yield,  regenerativeagriculture,  companionplanting"
838,13,4,5,0.4,1,1,"terrible crop yield,  bad net yield,  organicfarming,  irrigation"
839,29,2,22,0.8,20,0,"needs crop improvement,  bad net yield,  irrigation,  pollinatorfriendly"
840,15,11,20,1.3,9,1,"terrible crop yield,  good net yield,  pestcontrol,  naturalpestmanagement"
841,21,12,24,1.1,12,0,"commendable crop yield,  bad net yield,  pestcontrol,  croprotation"
842,16,12,8,0.5,-4,0,"needs crop improvement,  bad net yield,  croprotation,  naturalpestmanagement,  pestcontrol"
843,22,9,22,1,13,1,"terrible crop yield,  good net yield,  croprotation,  companionplanting,  pestcontrol"
844,21,3,14,0.7,11,1,"terrible crop yield,  good net yield,  irrigation,  fertilization,  vermiculture"
845,11,8,23,2.1,15,1,"needs improvement,  good net yield,  pestcontrol,  naturalpestmanagement"
846,28,1,20,0.7,19,0,"needs crop improvement,  bad net yield,  organicfarming,  pollinatorfriendly,  soilmanagement"
847,5,18,3,0.6,-15,1,"terrible crop yield,  bad net yield,  sustainableagriculture,  greenhousegrowing"
848,4,0,15,3.8,15,1,"needs improvement, good net yield, croprotation, greenhousegrowing, precisionfarming"
849,3,6,30,10,24,1,"good crop yield,  excellent net yield,  covercrops,  companionplanting"
850,19,16,5,0.3,-11,1,"terrible crop yield,  bad net yield,  companionplanting,  regenerativeagriculture"
851,20,2,17,0.9,15,1,"terrible crop yield,  good net yield,  soilmanagement,  irrigation"
852,25,19,8,0.3,-11,0,"needs crop improvement,  bad net yield,  sustainableagriculture,  greenhousegrowing"
853,18,19,26,1.4,7,0,"commendable crop yield,  bad net yield,  sustainableagriculture,  greenhousegrowing"
854,15,2,15,1,13,1,"terrible crop yield,  good net yield,  soilmanagement,  fertilization"
855,9,2,28,3.1,26,1,"needs improvement,  excellent net yield,  irrigation,  fertilization"
856,17,16,30,1.8,14,1,"terrible crop yield,  good net yield,  regenerativeagriculture,  companionplanting"
857,14,6,16,1.1,10,1,"terrible crop yield,  good net yield,  greenhousegrowing,  naturalpestmanagement,  covercrops"
858,15,13,25,1.7,12,0,"commendable crop yield,  bad net yield,  croprotation,  pestcontrol,  naturalpestmanagement"
859,1,16,4,4,-12,1,"needs improvement,  bad net yield,  companionplanting,  regenerativeagriculture"
860,21,17,3,0.1,-14,0,"needs crop improvement,  bad net yield,  regenerativeagriculture,  companionplanting"
861,22,12,8,0.4,-4,0,"needs crop improvement,  bad net yield,  naturalpestmanagement,  croprotation"
862,22,19,11,0.5,-8,1,"terrible crop yield,  bad net yield,  sustainableagriculture,  greenhousegrowing"
863,3,19,1,0.3,-18,0,"needs crop improvement,  bad net yield,  sustainableagriculture,  greenhousegrowing"
864,16,17,10,0.6,-7,0,"needs crop improvement,  bad net yield,  companionplanting,  regenerativeagriculture"
865,23,3,20,0.9,17,0,"needs crop improvement,  bad net yield,  pollinatorfriendly,  vermiculture"
866,25,0,3,0.1,3,0,"needs crop improvement, bad net yield, greenhousegrowing, precisionfarming, covercrops"
867,11,17,14,1.3,-3,1,"terrible crop yield,  bad net yield,  regenerativeagriculture,  companionplanting"
868,12,0,5,0.4,5,1,"terrible crop yield, bad net yield, greenhousegrowing, precisionfarming"
869,10,12,20,2,8,0,"commendable crop yield,  bad net yield,  pestcontrol,  naturalpestmanagement,  croprotation"
870,16,19,26,1.6,7,1,"terrible crop yield,  bad net yield,  greenhousegrowing,  sustainableagriculture"
871,8,19,12,1.5,-7,1,"terrible crop yield,  bad net yield,  greenhousegrowing,  sustainableagriculture"
872,6,9,8,1.3,-1,1,"terrible crop yield,  bad net yield,  croprotation,  sustainableagriculture"
873,12,10,13,1.1,3,1,"terrible crop yield,  bad net yield,  covercrops,  greenhousegrowing,  sustainableagriculture"
874,24,8,11,0.5,3,1,"terrible crop yield,  bad net yield,  naturalpestmanagement,  sustainableagriculture"
875,28,8,19,0.7,11,0,"needs crop improvement,  bad net yield,  precisionfarming,  naturalpestmanagement,  croprotation"
876,21,4,14,0.7,10,1,"terrible crop yield,  good net yield,  fertilization,  vermiculture"
877,8,0,8,1,8,1,"terrible crop yield, bad net yield, precisionfarming, covercrops, greenhousegrowing"
878,26,16,25,1,9,1,"terrible crop yield,  good net yield,  companionplanting,  regenerativeagriculture"
879,28,1,18,0.6,17,1,"terrible crop yield,  excellent net yield,  fertilization,  soilmanagement"
880,4,12,12,3,0,0,"commendable crop yield,  bad net yield,  pestcontrol,  naturalpestmanagement,  croprotation"
881,26,8,10,0.4,2,0,"needs crop improvement,  bad net yield,  sustainableagriculture,  greenhousegrowing"
882,8,3,8,1,5,0,"average crop yield,  bad net yield,  irrigation,  vermiculture"
883,26,4,24,0.9,20,0,"needs crop improvement,  bad net yield,  fertilization,  irrigation,  pollinatorfriendly"
884,28,10,5,0.2,-5,1,"terrible crop yield,  bad net yield,  naturalpestmanagement,  pestcontrol"
885,18,18,28,1.6,10,0,"commendable crop yield,  bad net yield,  sustainableagriculture,  greenhousegrowing"
886,28,2,5,0.2,3,1,"terrible crop yield,  bad net yield,  pollinatorfriendly,  soilmanagement"
887,28,11,23,0.8,12,1,"terrible crop yield,  good net yield,  naturalpestmanagement,  pestcontrol,  croprotation"
888,5,18,8,1.6,-10,1,"terrible crop yield,  bad net yield,  sustainableagriculture,  greenhousegrowing"
889,9,18,23,2.6,5,1,"needs improvement,  bad net yield,  sustainableagriculture,  greenhousegrowing"
890,4,12,2,0.5,-10,1,"terrible crop yield,  bad net yield,  pestcontrol,  naturalpestmanagement"
891,27,6,23,0.9,17,0,"needs crop improvement,  bad net yield,  naturalpestmanagement,  precisionfarming"
892,22,14,9,0.4,-5,0,"needs crop improvement,  bad net yield,  regenerativeagriculture,  companionplanting"
893,17,6,15,0.9,9,0,"needs crop improvement,  bad net yield,  greenhousegrowing,  sustainableagriculture,  companionplanting"
894,9,7,15,1.7,8,0,"commendable crop yield,  bad net yield,  covercrops,  companionplanting,  sustainableagriculture"
895,1,4,16,16,12,1,"commendable crop yield,  good net yield,  pollinatorfriendly,  organicfarming"
896,21,13,14,0.7,1,0,"needs crop improvement,  bad net yield,  naturalpestmanagement,  pestcontrol"
897,20,3,14,0.7,11,1,"terrible crop yield,  good net yield,  pollinatorfriendly,  fertilization,  irrigation"
898,13,9,18,1.4,9,0,"commendable crop yield,  bad net yield,  pestcontrol,  precisionfarming"
899,28,19,23,0.8,4,1,"terrible crop yield,  bad net yield,  sustainableagriculture,  greenhousegrowing"
900,16,14,23,1.4,9,1,"terrible crop yield,  good net yield,  regenerativeagriculture,  companionplanting"
901,29,17,20,0.7,3,0,"needs crop improvement,  bad net yield,  regenerativeagriculture,  companionplanting"
902,13,19,23,1.8,4,1,"terrible crop yield,  bad net yield,  sustainableagriculture,  greenhousegrowing"
903,14,12,29,2.1,17,1,"needs improvement,  excellent net yield,  pestcontrol,  naturalpestmanagement,  croprotation"
904,3,7,2,0.7,-5,0,"needs crop improvement,  bad net yield,  covercrops,  companionplanting"
905,29,8,27,0.9,19,1,"terrible crop yield,  excellent net yield,  precisionfarming,  pestcontrol,  covercrops"
906,6,15,16,2.7,1,0,"commendable crop yield,  bad net yield,  companionplanting,  regenerativeagriculture"
907,18,18,3,0.2,-15,0,"needs crop improvement,  bad net yield,  greenhousegrowing,  sustainableagriculture"
908,19,15,13,0.7,-2,0,"needs crop improvement,  bad net yield,  regenerativeagriculture,  companionplanting"
909,5,6,25,5,19,1,"average crop yield,  excellent net yield,  precisionfarming,  sustainableagriculture,  croprotation"
910,15,13,27,1.8,14,1,"terrible crop yield,  good net yield,  naturalpestmanagement,  croprotation"
911,25,13,26,1,13,1,"terrible crop yield,  good net yield,  naturalpestmanagement,  croprotation,  pestcontrol"
912,2,3,11,5.5,8,0,"commendable crop yield,  excellent net yield,  soilmanagement,  organicfarming,  fertilization"
913,10,14,11,1.1,-3,1,"terrible crop yield,  bad net yield,  regenerativeagriculture,  companionplanting"
914,24,2,6,0.3,4,0,"needs crop improvement,  bad net yield,  irrigation,  fertilization"
915,18,4,1,0.1,-3,0,"needs crop improvement,  bad net yield,  irrigation,  vermiculture"
916,27,0,17,0.6,17,1,"terrible crop yield, excellent net yield, covercrops, permaculture"
917,13,2,1,0.1,-1,0,"needs crop improvement,  bad net yield,  irrigation,  soilmanagement,  pollinatorfriendly"
918,5,14,27,5.4,13,1,"average crop yield,  good net yield,  companionplanting,  regenerativeagriculture"
919,23,7,28,1.2,21,1,"terrible crop yield,  excellent net yield,  croprotation,  sustainableagriculture,  companionplanting"
920,24,3,6,0.3,3,1,"terrible crop yield,  bad net yield,  irrigation,  soilmanagement,  organicfarming"
921,1,1,5,5,4,1,"average crop yield,  bad net yield,  organicfarming,  irrigation"
922,22,9,19,0.9,10,1,"terrible crop yield,  good net yield,  covercrops,  sustainableagriculture"
923,1,3,11,11,8,0,"commendable crop yield,  excellent net yield,  vermiculture,  organicfarming,  fertilization"
924,18,2,5,0.3,3,0,"needs crop improvement,  bad net yield,  irrigation,  vermiculture,  soilmanagement"
925,15,1,4,0.3,3,0,"needs crop improvement,  bad net yield,  irrigation,  pollinatorfriendly"
926,17,16,29,1.7,13,1,"terrible crop yield,  good net yield,  regenerativeagriculture,  companionplanting"
927,11,19,8,0.7,-11,1,"terrible crop yield,  bad net yield,  greenhousegrowing,  sustainableagriculture"
928,21,12,11,0.5,-1,1,"terrible crop yield,  bad net yield,  croprotation,  naturalpestmanagement,  pestcontrol"
929,26,4,19,0.7,15,0,"needs crop improvement,  bad net yield,  vermiculture,  pollinatorfriendly"
930,25,8,19,0.8,11,1,"terrible crop yield,  good net yield,  pestcontrol,  greenhousegrowing"
931,22,5,12,0.5,7,0,"needs crop improvement,  bad net yield,  pestcontrol,  croprotation"
932,27,4,11,0.4,7,0,"needs crop improvement,  bad net yield,  fertilization,  vermiculture,  soilmanagement"
933,27,9,11,0.4,2,1,"terrible crop yield,  bad net yield,  naturalpestmanagement,  covercrops"
934,17,7,2,0.1,-5,1,"terrible crop yield,  bad net yield,  naturalpestmanagement,  pestcontrol,  companionplanting"
935,13,6,16,1.2,10,0,"commendable crop yield,  bad net yield,  greenhousegrowing,  croprotation"
936,1,6,19,19,13,1,"commendable crop yield,  good net yield,  precisionfarming,  pestcontrol"
937,2,5,13,6.5,8,0,"commendable crop yield,  excellent net yield,  covercrops,  companionplanting"
938,9,19,16,1.8,-3,1,"terrible crop yield,  bad net yield,  sustainableagriculture,  greenhousegrowing"
939,3,2,18,6,16,1,"average crop yield,  excellent net yield,  soilmanagement,  irrigation,  organicfarming"
940,1,18,21,21,3,0,"commendable crop yield,  excellent net yield,  greenhousegrowing,  sustainableagriculture"
941,21,14,13,0.6,-1,1,"terrible crop yield,  bad net yield,  companionplanting,  regenerativeagriculture"
942,16,3,2,0.1,-1,0,"needs crop improvement,  bad net yield,  organicfarming,  fertilization"
943,23,11,2,0.1,-9,1,"terrible crop yield,  bad net yield,  croprotation,  naturalpestmanagement,  pestcontrol"
944,6,5,28,4.7,23,0,"commendable crop yield,  excellent net yield,  croprotation,  pestcontrol"
945,28,18,6,0.2,-12,0,"needs crop improvement,  bad net yield,  sustainableagriculture,  greenhousegrowing"
946,17,3,18,1.1,15,1,"terrible crop yield,  good net yield,  vermiculture,  pollinatorfriendly"
947,5,14,27,5.4,13,0,"commendable crop yield,  excellent net yield,  companionplanting,  regenerativeagriculture"
948,5,8,17,3.4,9,1,"needs improvement,  good net yield,  croprotation,  greenhousegrowing"
949,6,4,6,1,2,1,"terrible crop yield,  bad net yield,  irrigation,  fertilization"
950,3,12,16,5.3,4,1,"average crop yield,  bad net yield,  pestcontrol,  croprotation,  naturalpestmanagement"
951,21,17,25,1.2,8,0,"commendable crop yield,  bad net yield,  regenerativeagriculture,  companionplanting"
952,23,4,3,0.1,-1,0,"needs crop improvement,  bad net yield,  organicfarming,  vermiculture,  pollinatorfriendly"
953,5,15,8,1.6,-7,1,"terrible crop yield,  bad net yield,  regenerativeagriculture,  companionplanting"
954,21,18,12,0.6,-6,1,"terrible crop yield,  bad net yield,  greenhousegrowing,  sustainableagriculture"
955,5,13,25,5,12,0,"commendable crop yield,  excellent net yield,  croprotation,  pestcontrol,  naturalpestmanagement"
956,10,15,10,1,-5,1,"terrible crop yield,  bad net yield,  companionplanting,  regenerativeagriculture"
957,10,14,15,1.5,1,1,"terrible crop yield,  bad net yield,  regenerativeagriculture,  companionplanting"
958,19,3,26,1.4,23,0,"commendable crop yield,  excellent net yield,  pollinatorfriendly,  organicfarming,  vermiculture"
959,17,6,30,1.8,24,1,"terrible crop yield,  excellent net yield,  croprotation,  precisionfarming,  companionplanting"
960,21,15,3,0.1,-12,0,"needs crop improvement,  bad net yield,  regenerativeagriculture,  companionplanting"
961,14,7,26,1.9,19,1,"terrible crop yield,  excellent net yield,  pestcontrol,  croprotation"
962,9,16,28,3.1,12,0,"commendable crop yield,  excellent net yield,  companionplanting,  regenerativeagriculture"
963,14,15,4,0.3,-11,1,"terrible crop yield,  bad net yield,  regenerativeagriculture,  companionplanting"
964,1,9,8,8,-1,1,"good crop yield,  bad net yield,  companionplanting,  greenhousegrowing,  covercrops"
965,19,9,20,1.1,11,0,"commendable crop yield,  bad net yield,  greenhousegrowing,  precisionfarming,  covercrops"
966,13,1,19,1.5,18,1,"terrible crop yield,  excellent net yield,  organicfarming,  irrigation,  fertilization"
967,13,8,18,1.4,10,0,"commendable crop yield,  bad net yield,  precisionfarming,  croprotation"
968,4,16,11,2.8,-5,1,"needs improvement,  bad net yield,  regenerativeagriculture,  companionplanting"
969,1,10,19,19,9,0,"commendable crop yield,  excellent net yield,  naturalpestmanagement,  covercrops,  sustainableagriculture"
970,17,9,28,1.6,19,0,"commendable crop yield,  excellent net yield,  croprotation,  sustainableagriculture,  covercrops"
971,8,16,12,1.5,-4,0,"commendable crop yield,  bad net yield,  regenerativeagriculture,  companionplanting"
972,2,3,25,12.5,22,0,"commendable crop yield,  excellent net yield,  fertilization,  vermiculture"
973,28,15,18,0.6,3,1,"terrible crop yield,  bad net yield,  regenerativeagriculture,  companionplanting"
974,8,19,12,1.5,-7,1,"terrible crop yield,  bad net yield,  sustainableagriculture,  greenhousegrowing"
975,7,14,15,2.1,1,0,"commendable crop yield,  bad net yield,  regenerativeagriculture,  companionplanting"
976,26,4,12,0.5,8,0,"needs crop improvement,  bad net yield,  fertilization,  soilmanagement"
977,26,5,12,0.5,7,0,"needs crop improvement,  bad net yield,  croprotation,  pestcontrol"
978,2,16,15,7.5,-1,1,"average crop yield,  bad net yield,  companionplanting,  regenerativeagriculture"
979,22,0,20,0.9,20,1,"terrible crop yield, excellent net yield, greenhousegrowing, permaculture"
980,22,18,5,0.2,-13,1,"terrible crop yield,  bad net yield,  sustainableagriculture,  greenhousegrowing"
981,3,3,27,9,24,1,"good crop yield,  excellent net yield,  fertilization,  irrigation"
982,27,16,22,0.8,6,0,"needs crop improvement,  bad net yield,  companionplanting,  regenerativeagriculture"
983,18,8,3,0.2,-5,0,"needs crop improvement,  bad net yield,  naturalpestmanagement,  greenhousegrowing"
984,12,1,12,1,11,0,"average crop yield,  bad net yield,  irrigation,  soilmanagement,  organicfarming"
985,1,7,14,14,7,1,"good crop yield,  bad net yield,  greenhousegrowing,  precisionfarming,  naturalpestmanagement"
986,22,14,15,0.7,1,1,"terrible crop yield,  bad net yield,  regenerativeagriculture,  companionplanting"
987,12,6,5,0.4,-1,1,"terrible crop yield,  bad net yield,  greenhousegrowing,  sustainableagriculture"
988,5,5,21,4.2,16,0,"commendable crop yield,  excellent net yield,  sustainableagriculture,  covercrops,  precisionfarming"
989,27,0,28,1,28,0,"average crop yield,  excellent net yield,  farmersmarket,  foodsecurity,  localfood"
990,25,14,2,0.1,-12,1,"terrible crop yield,  bad net yield,  companionplanting,  regenerativeagriculture"
991,17,6,26,1.5,20,0,"commendable crop yield,  excellent net yield,  sustainableagriculture,  pestcontrol"
992,16,16,4,0.3,-12,1,"terrible crop yield,  bad net yield,  companionplanting,  regenerativeagriculture"
993,15,1,10,0.7,9,1,"terrible crop yield,  good net yield,  pollinatorfriendly,  organicfarming"
994,23,8,3,0.1,-5,0,"needs crop improvement,  bad net yield,  sustainableagriculture,  croprotation"
995,15,8,2,0.1,-6,1,"terrible crop yield,  bad net yield,  croprotation,  precisionfarming"
996,5,12,2,0.4,-10,0,"needs crop improvement,  bad net yield,  naturalpestmanagement,  croprotation"
997,21,5,7,0.3,2,1,"terrible crop yield,  bad net yield,  precisionfarming,  sustainableagriculture"
998,14,5,19,1.4,14,0,"commendable crop yield,  good net yield,  croprotation,  pestcontrol,  covercrops"
999,2,19,15,7.5,-4,0,"commendable crop yield,  bad net yield,  greenhousegrowing,  sustainableagriculture"
1000,11,19,18,1.6,-1,0,"commendable crop yield,  bad net yield,  greenhousegrowing,  sustainableagriculture"
1001,20,0,200,10,200,1,"good crop yield, excellent net yield, farmersmarket, foodsecurity"
1002,9,0,108,12,108,1,"good crop yield, excellent net yield, foodsecurity, farmtofork"
1003,10,0,58,5.8,58,1,"average crop yield, excellent net yield, foodsecurity, farmersmarket, farmtofork"
1004,15,0,92,6.1,92,1,"average crop yield, excellent net yield, farmtofork, localfood"
1005,11,0,78,7.1,78,1,"average crop yield, excellent net yield, farmtofork, foodsecurity"
1006,8,0,64,8,64,1,"good crop yield, excellent net yield, localfood, foodsecurity"
1007,29,0,253,8.7,253,1,"good crop yield, excellent net yield, farmersmarket, foodsecurity"
1008,21,0,21,1,21,0,"average crop yield, good net yield, localfood, foodsecurity, farmersmarket"
1009,7,0,8,1.1,8,0,"commendable crop yield, excellent net yield, farmersmarket, foodsecurity, farmtofork"
1010,26,0,187,7.2,187,1,"average crop yield, excellent net yield, foodsecurity, localfood, farmtofork"
1011,19,0,19,1,19,0,"average crop yield, good net yield, foodsecurity, farmtofork"
1012,23,0,24,1,24,0,"average crop yield, excellent net yield, farmersmarket, foodsecurity, localfood"
1013,11,0,13,1.2,13,0,"commendable crop yield, excellent net yield, farmersmarket, farmtofork, foodsecurity"
1014,11,0,12,1.1,12,0,"commendable crop yield, excellent net yield, farmtofork, localfood"
1015,24,0,168,7,168,1,"average crop yield, excellent net yield, localfood, farmtofork"
1016,21,0,21,1,21,0,"average crop yield, good net yield, localfood, farmersmarket"
1017,4,0,27,6.8,27,1,"average crop yield, excellent net yield, foodsecurity, farmtofork"
1018,8,0,8,1,8,0,"average crop yield, good net yield, farmersmarket, farmtofork"
1019,24,0,25,1,25,0,"average crop yield, excellent net yield, farmtofork, foodsecurity"
1020,3,0,3,1,3,0,"average crop yield, good net yield, farmersmarket, localfood"
1021,22,0,149,6.8,149,1,"average crop yield, excellent net yield, farmtofork, localfood, foodsecurity"
1022,21,0,21,1,21,0,"average crop yield, good net yield, foodsecurity, localfood, farmersmarket"
1023,2,0,18,9,18,1,"good crop yield, excellent net yield, farmtofork, foodsecurity"
1024,24,0,25,1,25,0,"average crop yield, excellent net yield, localfood, farmersmarket"
1025,12,0,122,10.2,122,1,"good crop yield, excellent net yield, foodsecurity, farmtofork, localfood"
1026,6,0,7,1.2,7,0,"commendable crop yield, excellent net yield, foodsecurity, farmtofork, localfood"
1027,2,0,12,6,12,1,"average crop yield, good net yield, localfood, farmersmarket"
1028,28,0,231,8.3,231,1,"good crop yield, excellent net yield, localfood, foodsecurity"
1029,21,0,21,1,21,0,"average crop yield, good net yield, localfood, farmtofork, farmersmarket"
1030,1,0,10,10,10,1,"good crop yield, good net yield, farmtofork, farmersmarket, localfood"
1031,12,0,15,1.3,15,0,"commendable crop yield, excellent net yield, foodsecurity, farmersmarket"
1032,26,0,26,1,26,0,"average crop yield, good net yield, farmersmarket, foodsecurity, farmtofork"
1033,22,0,22,1,22,0,"average crop yield, good net yield, farmtofork, localfood"
1034,29,0,30,1,30,0,"average crop yield, excellent net yield, farmersmarket, farmtofork"
1035,12,0,13,1.1,13,0,"commendable crop yield, excellent net yield, farmersmarket, localfood"
1036,25,0,25,1,25,0,"average crop yield, good net yield, foodsecurity, localfood"
1037,17,0,19,1.1,19,0,"commendable crop yield, excellent net yield, localfood, foodsecurity, farmersmarket"
1038,27,0,28,1,28,0,"average crop yield, excellent net yield, localfood, foodsecurity, farmtofork"
1039,27,0,27,1,27,0,"average crop yield, good net yield, farmtofork, foodsecurity"
1040,10,0,10,1,10,0,"average crop yield, good net yield, localfood, farmtofork"
1041,28,0,28,1,28,0,"average crop yield, good net yield, foodsecurity, localfood, farmtofork"
1042,7,0,83,11.9,83,1,"good crop yield, excellent net yield, farmtofork, farmersmarket, foodsecurity"
1043,16,0,141,8.8,141,1,"good crop yield, excellent net yield, localfood, farmtofork, foodsecurity"
1044,15,0,15,1,15,0,"average crop yield, good net yield, farmersmarket, foodsecurity, localfood"
1045,15,0,16,1.1,16,0,"commendable crop yield, excellent net yield, localfood, farmtofork, farmersmarket"
1046,19,0,19,1,19,0,"average crop yield, good net yield, farmtofork, foodsecurity, farmersmarket"
1047,12,0,12,1,12,0,"average crop yield, good net yield, foodsecurity, localfood"
1048,23,0,23,1,23,0,"average crop yield, good net yield, farmtofork, foodsecurity"
1049,20,0,20,1,20,0,"average crop yield, good net yield, foodsecurity, localfood, farmersmarket"
1050,25,0,26,1,26,0,"average crop yield, excellent net yield, foodsecurity, localfood"
1051,7,12,15,2.1,3,1,"needs improvement,  bad net yield,  naturalpestmanagement,  pestcontrol"
1052,20,6,17,0.8,11,1,"terrible crop yield,  good net yield,  croprotation,  companionplanting,  precisionfarming"
1053,29,18,16,0.6,-2,1,"terrible crop yield,  bad net yield,  greenhousegrowing,  sustainableagriculture"
1054,15,1,9,0.6,8,1,"terrible crop yield,  bad net yield,  pollinatorfriendly,  soilmanagement,  irrigation"
1055,11,9,15,1.4,6,1,"terrible crop yield,  bad net yield,  naturalpestmanagement,  croprotation,  companionplanting"
1056,8,12,24,3,12,1,"needs improvement,  good net yield,  naturalpestmanagement,  pestcontrol,  croprotation"
1057,29,5,29,1,24,1,"terrible crop yield,  excellent net yield,  companionplanting,  croprotation"
1058,21,11,23,1.1,12,0,"commendable crop yield,  bad net yield,  naturalpestmanagement,  pestcontrol"
1059,7,11,24,3.4,13,0,"commendable crop yield,  excellent net yield,  pestcontrol,  croprotation,  naturalpestmanagement"
1060,26,19,22,0.8,3,1,"terrible crop yield,  bad net yield,  sustainableagriculture,  greenhousegrowing"
1061,19,10,3,0.2,-7,0,"needs crop improvement,  bad net yield,  sustainableagriculture,  covercrops"
1062,23,6,12,0.5,6,0,"needs crop improvement,  bad net yield,  precisionfarming,  greenhousegrowing"
1063,11,0,8,0.7,8,0,"needs crop improvement, bad net yield, waterconservation, raisedbeds"
1064,11,0,22,2,22,0,"commendable crop yield,  excellent net yield,  foodsecurity,  farmersmarket,  localfood"
1065,24,19,22,0.9,3,1,"terrible crop yield,  bad net yield,  greenhousegrowing,  sustainableagriculture"
1066,21,12,3,0.1,-9,0,"needs crop improvement,  bad net yield,  pestcontrol,  naturalpestmanagement,  croprotation"
1067,4,8,27,6.8,19,1,"average crop yield,  excellent net yield,  sustainableagriculture,  croprotation,  greenhousegrowing"
1068,8,2,3,0.4,1,0,"needs crop improvement,  bad net yield,  irrigation,  pollinatorfriendly"
1069,24,6,5,0.2,-1,0,"needs crop improvement,  bad net yield,  companionplanting,  greenhousegrowing"
1070,3,5,15,5,10,0,"commendable crop yield,  excellent net yield,  sustainableagriculture,  croprotation,  covercrops"
1071,22,7,29,1.3,22,1,"terrible crop yield,  excellent net yield,  naturalpestmanagement,  greenhousegrowing"
1072,21,8,3,0.1,-5,0,"needs crop improvement,  bad net yield,  precisionfarming,  sustainableagriculture"
1073,2,4,10,5,6,1,"average crop yield,  bad net yield,  fertilization,  pollinatorfriendly,  vermiculture"
1074,24,0,5,0.2,5,0,"needs crop improvement, bad net yield, precisionfarming, croprotation, covercrops"
1075,12,18,16,1.3,-2,1,"terrible crop yield,  bad net yield,  sustainableagriculture,  greenhousegrowing"
1076,6,9,23,3.8,14,0,"commendable crop yield,  excellent net yield,  croprotation,  naturalpestmanagement,  greenhousegrowing"
1077,2,11,2,1,-9,1,"terrible crop yield,  bad net yield,  naturalpestmanagement,  pestcontrol,  croprotation"
1078,28,14,26,0.9,12,1,"terrible crop yield,  good net yield,  regenerativeagriculture,  companionplanting"
1079,21,8,27,1.3,19,0,"commendable crop yield,  bad net yield,  precisionfarming,  pestcontrol"
1080,1,19,10,10,-9,1,"good crop yield,  bad net yield,  sustainableagriculture,  greenhousegrowing"
1081,12,16,15,1.2,-1,0,"commendable crop yield,  bad net yield,  companionplanting,  regenerativeagriculture"
1082,26,16,15,0.6,-1,0,"needs crop improvement,  bad net yield,  companionplanting,  regenerativeagriculture"
1083,22,19,26,1.2,7,0,"commendable crop yield,  bad net yield,  sustainableagriculture,  greenhousegrowing"
1084,29,11,10,0.3,-1,0,"needs crop improvement,  bad net yield,  naturalpestmanagement,  croprotation,  pestcontrol"
1085,12,6,28,2.3,22,0,"commendable crop yield,  excellent net yield,  greenhousegrowing,  covercrops,  naturalpestmanagement"
1086,25,1,13,0.5,12,0,"needs crop improvement,  bad net yield,  vermiculture,  fertilization"
1087,17,2,19,1.1,17,0,"commendable crop yield,  good net yield,  irrigation,  vermiculture"
1088,27,16,7,0.3,-9,0,"needs crop improvement,  bad net yield,  regenerativeagriculture,  companionplanting"
1089,27,4,17,0.6,13,0,"needs crop improvement,  bad net yield,  vermiculture,  irrigation,  soilmanagement"
1090,10,16,20,2,4,0,"commendable crop yield,  bad net yield,  companionplanting,  regenerativeagriculture"
1091,28,16,29,1,13,0,"average crop yield,  bad net yield,  regenerativeagriculture,  companionplanting"
1092,28,16,2,0.1,-14,1,"terrible crop yield,  bad net yield,  regenerativeagriculture,  companionplanting"
1093,16,1,28,1.8,27,1,"terrible crop yield,  excellent net yield,  fertilization,  vermiculture,  irrigation"
1094,15,1,23,1.5,22,0,"commendable crop yield,  excellent net yield,  fertilization,  organicfarming,  pollinatorfriendly"
1095,15,4,7,0.5,3,0,"needs crop improvement,  bad net yield,  pollinatorfriendly,  fertilization,  vermiculture"
1096,19,0,13,0.7,13,0,"needs crop improvement, bad net yield, mulching, sustainablepractices"
1097,12,0,15,1.2,15,0,"commendable crop yield,  excellent net yield,  farmersmarket,  farmtofork"
1098,23,18,11,0.5,-7,0,"needs crop improvement,  bad net yield,  sustainableagriculture,  greenhousegrowing"
1099,20,1,29,1.4,28,0,"commendable crop yield,  excellent net yield,  fertilization,  soilmanagement"
1100,25,11,4,0.2,-7,0,"needs crop improvement,  bad net yield,  naturalpestmanagement,  croprotation,  pestcontrol"
